Neutron Number,Proton Number,Atomic Number,Element Name,Binding Energy per Nucleon (keV),Uncertainty (keV)
1,0,1,n,0.0,0.0
0,1,1,H,0.0,0.0
1,1,2,H,1112.2831,0.0002
2,1,3,H,2827.2654,0.0003
1,2,3,He,2572.68044,0.00015
3,1,4,H,1720.4491,25.0
2,2,4,He,7073.9156,0.0002
1,3,4,Li,1153.7603,53.033
4,1,5,H,1336.3592,17.8885
3,2,5,He,5512.1325,4.0
2,3,5,Li,5266.1325,10.0
5,1,6,H,961.6395,42.3545
4,2,6,He,4878.5199,0.0089
3,3,6,Li,5332.3312,0.0003
2,4,6,Be,4487.2478,0.908
5,2,7,He,4123.0578,1.0799
4,3,7,Li,5606.4401,0.0006
3,4,7,Be,5371.5487,0.0101
2,5,7,B,3558.7055,3.5929
6,2,8,He,3924.521,0.0111
5,3,8,Li,5159.7124,0.0059
4,4,8,Be,7062.4356,0.0044
3,5,8,B,4717.1551,0.125
2,6,8,C,3101.5242,2.2804
7,2,9,He,3349.038,5.2018
6,3,9,Li,5037.7685,0.0207
5,4,9,Be,6462.6693,0.0085
4,5,9,B,6257.0713,0.1003
3,6,9,C,4337.4233,0.2374
8,2,10,He,2995.134,9.2848
7,3,10,Li,4531.3512,1.2721
6,4,10,Be,6497.6306,0.0081
5,5,10,B,6475.0835,0.0015
4,6,10,C,6032.0426,0.007
3,7,10,N,3643.6724,40.0
8,3,11,Li,4155.3817,0.0559
7,4,11,Be,5952.5402,0.0216
6,5,11,B,6927.7323,0.0011
5,6,11,C,6676.4563,0.0054
4,7,11,N,5358.4023,0.4546
3,8,11,O,3162.4372,5.458
9,3,12,Li,3791.5999,2.5005
8,4,12,Be,5720.7223,0.159
7,5,12,B,6631.2237,0.1101
6,6,12,C,7680.1446,0.0002
5,7,12,N,6170.11,0.0833
4,8,12,O,4881.9755,1.0
10,3,13,Li,3507.6307,5.3848
9,4,13,Be,5241.4359,0.7831
8,5,13,B,6496.4194,0.0769
7,6,13,C,7469.8495,0.0002
6,7,13,N,7238.8634,0.0207
5,8,13,O,5811.7636,0.7328
10,4,14,Be,4993.8973,9.4461
9,5,14,B,6101.6451,1.5152
8,6,14,C,7520.3198,0.0004
7,7,14,N,7475.6148,0.0002
6,8,14,O,7052.2783,0.0018
5,9,14,F,5285.2091,2.9371
11,4,15,Be,4540.9708,11.0532
10,5,15,B,5880.0438,1.4019
9,6,15,C,7100.1696,0.0533
8,7,15,N,7699.4603,0.0002
7,8,15,O,7463.6915,0.0327
6,9,15,F,6497.4597,0.9333
5,10,15,Ne,4868.7285,4.4456
12,4,16,Be,4285.2851,10.3623
11,5,16,B,5507.3535,1.5354
10,6,16,C,6922.0546,0.2236
9,7,16,N,7373.7971,0.1438
8,8,16,O,7976.2072,0.0002
7,9,16,F,6964.049,0.3353
6,10,16,Ne,6083.1777,1.28
12,5,17,B,5269.6677,12.0061
11,6,17,C,6558.0262,1.0215
10,7,17,N,7286.2294,0.8824
9,8,17,O,7750.7291,0.0002
8,9,17,F,7542.3284,0.0146
7,10,17,Ne,6640.4991,0.0208
6,11,17,Na,5522.7653,3.5068
13,5,18,B,4976.6306,11.3425
12,6,18,C,6426.1321,1.6667
11,7,18,N,7038.5627,1.0316
10,8,18,O,7767.0981,0.0002
9,9,18,F,7631.6383,0.0257
8,10,18,Ne,7341.2577,0.0202
7,11,18,Na,6202.2176,5.2156
14,5,19,B,4719.6346,27.6507
13,6,19,C,6118.274,5.1784
12,7,19,N,6948.5452,0.8634
11,8,19,O,7566.4952,0.1388
10,9,19,F,7779.0192,0.0002
9,10,19,Ne,7567.3431,0.0084
8,11,19,Na,6937.8864,0.5545
7,12,19,Mg,5901.4992,3.1579
15,5,20,B,4405.6529,27.3178
14,6,20,C,5961.4356,11.5312
13,7,20,N,6709.1717,3.9447
12,8,20,O,7568.5707,0.0442
11,9,20,F,7720.1351,0.0015
10,10,20,Ne,8032.2412,0.0002
9,11,20,Na,7298.5028,0.0554
8,12,20,Mg,6728.0252,0.0931
16,5,21,B,4152.5265,26.6031
14,7,21,N,6609.0159,6.3832
13,8,21,O,7389.3747,0.5714
12,9,21,F,7738.2934,0.0857
11,10,21,Ne,7971.7136,0.0018
10,11,21,Na,7765.5581,0.002
9,12,21,Mg,7105.0317,0.0359
16,6,22,C,5421.0778,10.5223
15,7,22,N,6378.5347,9.4445
14,8,22,O,7364.8722,2.5873
13,9,22,F,7624.2954,0.5636
12,10,22,Ne,8080.4656,0.0008
11,11,22,Na,7915.6624,0.006
10,12,22,Mg,7662.7645,0.0072
16,7,23,N,6236.6721,18.2856
15,8,23,O,7163.4856,5.2918
14,9,23,F,7622.3447,1.4487
13,10,23,Ne,7955.2561,0.0045
12,11,23,Na,8111.4936,0.0002
11,12,23,Mg,7901.1229,0.0014
10,13,23,Al,7335.7275,0.015
16,8,24,O,7039.6855,6.8698
15,9,24,F,7463.5831,4.0696
14,10,24,Ne,7993.3252,0.0214
13,11,24,Na,8063.4882,0.0007
12,12,24,Mg,8260.7103,0.0006
11,13,24,Al,7649.5806,0.0095
10,14,24,Si,7167.2329,0.8113
17,8,25,O,6727.8058,6.6034
16,9,25,F,7336.3065,3.8577
15,10,25,Ne,7839.7994,1.1618
14,11,25,Na,8101.3979,0.048
13,12,25,Mg,8223.5028,0.0019
12,13,25,Al,8021.1366,0.0026
11,14,25,Si,7480.1109,0.4
18,8,26,O,6497.479,6.3442
17,9,26,F,7082.2497,4.1164
16,10,26,Ne,7751.911,0.7088
15,11,26,Na,8004.2013,0.1347
14,12,26,Mg,8333.8711,0.0011
13,13,26,Al,8149.7653,0.0026
12,14,26,Si,7924.7083,0.0041
18,9,27,F,6879.6662,4.4518
17,10,27,Ne,7520.4151,3.3619
16,11,27,Na,7956.9467,0.138
15,12,27,Mg,8263.8525,0.0018
14,13,27,Al,8331.5533,0.0018
13,14,27,Si,8124.342,0.004
12,15,27,P,7661.0894,0.3334
19,9,28,F,6626.8567,4.2981
18,10,28,Ne,7388.3463,4.5024
17,11,28,Na,7799.2644,0.3659
16,12,28,Mg,8272.4531,0.0093
15,13,28,Al,8309.8969,0.0018
14,14,28,Si,8447.7445,0.0002
13,15,28,P,7907.4842,0.041
12,16,28,S,7478.7911,5.7143
20,9,29,F,6444.0314,18.116
19,10,29,Ne,7167.0673,5.1553
18,11,29,Na,7682.1522,0.253
17,12,29,Mg,8113.5317,0.0119
16,13,29,Al,8348.4647,0.0119
15,14,29,Si,8448.6361,0.0002
14,15,29,P,8251.2368,0.0124
13,16,29,S,7746.3826,0.4497
20,10,30,Ne,7034.5317,8.4417
19,11,30,Na,7501.9685,0.1576
18,12,30,Mg,8054.425,0.0432
17,13,30,Al,8261.1049,0.0645
16,14,30,Si,8520.6549,0.0008
15,15,30,P,8353.5064,0.0022
14,16,30,S,8122.7081,0.0069
13,17,30,Cl,7472.1698,0.7959
21,10,31,Ne,6813.0902,8.5869
20,11,31,Na,7398.6778,0.4507
19,12,31,Mg,7869.1886,0.0992
18,13,31,Al,8225.518,0.0721
17,14,31,Si,8458.2916,0.0014
16,15,31,P,8481.1677,0.0002
15,16,31,S,8281.8013,0.0074
14,17,31,Cl,7869.2101,0.1112
21,11,32,Na,7219.8815,1.1644
20,12,32,Mg,7803.8411,0.1019
19,13,32,Al,8100.3449,0.2241
18,14,32,Si,8481.469,0.0093
17,15,32,P,8464.1203,0.0013
16,16,32,S,8493.1301,0.0002
15,17,32,Cl,8072.4058,0.0176
14,18,32,Ar,7700.0089,0.0553
22,11,33,Na,7089.9262,13.6337
21,12,33,Mg,7636.4382,0.0807
20,13,33,Al,8020.6172,0.2117
19,14,33,Si,8361.0596,0.0212
18,15,33,P,8513.8073,0.033
17,16,33,S,8497.6304,0.0002
16,17,33,Cl,8304.7557,0.0118
15,18,33,Ar,7928.9559,0.0121
23,11,34,Na,6886.4377,17.6299
22,12,34,Mg,7550.3919,0.2027
21,13,34,Al,7860.3506,0.0619
20,14,34,Si,8337.1659,0.0236
19,15,34,P,8448.1856,0.0238
18,16,34,S,8583.4986,0.0013
17,17,34,Cl,8398.9706,0.0014
16,18,34,Ar,8197.6724,0.0023
23,12,35,Mg,7356.2338,7.7048
22,13,35,Al,7787.1243,0.2103
21,14,35,Si,8169.5644,1.0245
20,15,35,P,8446.2496,0.0533
19,16,35,S,8537.8511,0.0012
18,17,35,Cl,8520.279,0.001
17,18,35,Ar,8327.4621,0.0194
16,19,35,K,7965.8409,0.0146
24,12,36,Mg,7244.4202,19.1733
23,13,36,Al,7623.5154,4.1529
22,14,36,Si,8112.5199,1.9944
21,15,36,P,8307.8692,0.3643
20,16,36,S,8575.39,0.0052
19,17,36,Cl,8521.9322,0.001
18,18,36,Ar,8519.9096,0.0008
17,19,36,K,8142.2233,0.009
16,20,36,Ca,7815.8799,1.1111
25,12,37,Mg,7055.1115,18.8905
24,13,37,Al,7531.316,4.8715
23,14,37,Si,7952.9033,3.0759
22,15,37,P,8267.5561,1.0256
21,16,37,S,8459.9363,0.0054
20,17,37,Cl,8570.2816,0.0014
19,18,37,Ar,8527.1406,0.0056
18,19,37,K,8339.848,0.0025
17,20,37,Ca,8003.4567,0.0171
24,14,38,Si,7892.8297,2.7577
23,15,38,P,8147.2749,1.91
22,16,38,S,8448.7829,0.1887
21,17,38,Cl,8505.4817,0.0026
20,18,38,Ar,8614.2807,0.0051
19,19,38,K,8438.0593,0.0051
18,20,38,Ca,8240.0434,0.0051
25,14,39,Si,7730.9793,3.4752
24,15,39,P,8097.9701,2.8883
23,16,39,S,8344.2698,1.2821
22,17,39,Cl,8494.4032,0.0444
21,18,39,Ar,8562.5988,0.1282
20,19,39,K,8557.0258,0.0003
19,20,39,Ca,8369.6711,0.0153
18,21,39,Sc,8013.4575,0.6154
26,14,40,Si,7655.8247,3.0498
25,15,40,P,7981.4177,2.0902
24,16,40,S,8329.3255,0.0996
23,17,40,Cl,8427.766,0.8016
22,18,40,Ar,8595.2594,0.0002
21,19,40,K,8538.0907,0.0014
20,20,40,Ca,8551.3046,0.0006
19,21,40,Sc,8173.6697,0.0707
18,22,40,Ti,7865.8632,1.7061
26,15,41,P,7906.5513,2.9308
25,16,41,S,8229.6358,0.1
24,17,41,Cl,8412.9593,1.6762
23,18,41,Ar,8534.3733,0.0085
22,19,41,K,8576.0731,0.0003
21,20,41,Ca,8546.7075,0.0034
20,21,41,Sc,8369.1979,0.0019
19,22,41,Ti,8034.3889,0.6816
27,15,42,P,7765.9122,2.2621
26,16,42,S,8193.2275,0.0665
25,17,42,Cl,8345.8864,1.4194
24,18,42,Ar,8555.6141,0.1375
23,19,42,K,8551.2571,0.0025
22,20,42,Ca,8616.5646,0.0035
21,21,42,Sc,8444.9303,0.0037
20,22,42,Ti,8259.24,0.0064
27,16,43,S,8063.8276,0.1156
26,17,43,Cl,8323.8672,1.4386
25,18,43,Ar,8488.2382,0.1235
24,19,43,K,8576.2204,0.0095
23,20,43,Ca,8600.6653,0.0053
22,21,43,Sc,8530.8265,0.0433
21,22,43,Ti,8352.8054,0.133
20,23,43,V,8069.5129,0.9965
28,16,44,S,7996.0154,0.1186
27,17,44,Cl,8234.4788,1.9447
26,18,44,Ar,8493.8411,0.036
25,19,44,K,8546.7023,0.0095
24,20,44,Ca,8658.1769,0.0074
23,21,44,Sc,8557.3805,0.0399
22,22,44,Ti,8533.5215,0.0159
21,23,44,V,8203.4567,0.1651
20,24,44,Cr,7949.6265,1.1644
28,17,45,Cl,8181.5991,3.0259
27,18,45,Ar,8419.9526,0.0114
26,19,45,K,8554.6747,0.0116
25,20,45,Ca,8630.5467,0.0081
24,21,45,Sc,8618.941,0.0147
23,22,45,Ti,8555.7321,0.0186
22,23,45,V,8380.0394,0.0192
21,24,45,Cr,8087.7286,0.7866
29,17,46,Cl,8080.7757,2.1141
28,18,46,Ar,8412.3835,0.0506
27,19,46,K,8518.0428,0.0158
26,20,46,Ca,8668.9848,0.0486
25,21,46,Sc,8622.0215,0.0146
24,22,46,Ti,8656.4623,0.002
23,23,46,V,8486.1423,0.0029
22,24,46,Cr,8303.8233,0.249
21,25,46,Mn,7916.0805,1.8832
29,18,47,Ar,8311.425,0.0258
28,19,47,K,8514.8795,0.0297
27,20,47,Ca,8639.3548,0.0473
26,21,47,Sc,8665.0958,0.0411
25,22,47,Ti,8661.2325,0.0017
24,23,47,V,8582.2348,0.0024
23,24,47,Cr,8407.2067,0.1106
22,25,47,Mn,8135.3117,0.6738
30,18,48,Ar,8243.6656,0.3493
29,19,48,K,8434.2324,0.0161
28,20,48,Ca,8666.6916,0.0004
27,21,48,Sc,8656.2097,0.1031
26,22,48,Ti,8723.0122,0.0016
25,23,48,V,8623.0686,0.0202
24,24,48,Cr,8572.2553,0.1523
23,25,48,Mn,8274.1924,0.1396
22,26,48,Fe,8022.7254,1.9212
30,19,49,K,8372.2753,0.0164
29,20,49,Ca,8594.85,0.0036
28,21,49,Sc,8686.2805,0.0463
27,22,49,Ti,8711.1625,0.0016
26,23,49,V,8682.9135,0.0168
25,24,49,Cr,8613.2777,0.0449
24,25,49,Mn,8439.915,0.0452
23,26,49,Fe,8161.3121,0.4943
31,19,50,K,8288.5833,0.1546
30,20,50,Ca,8550.1639,0.0317
29,21,50,Sc,8633.4747,0.0503
28,22,50,Ti,8755.7227,0.0017
27,23,50,V,8695.9032,0.0019
26,24,50,Cr,8701.0188,0.0019
25,25,50,Mn,8532.6823,0.0023
24,26,50,Fe,8354.0268,0.1677
23,27,50,Co,8000.6387,2.515
32,19,51,K,8221.335,0.2557
31,20,51,Ca,8476.9135,0.0102
30,21,51,Sc,8597.2213,0.0493
29,22,51,Ti,8708.9912,0.0095
28,23,51,V,8742.0852,0.0019
27,24,51,Cr,8711.9923,0.0033
26,25,51,Mn,8633.7602,0.006
25,26,51,Fe,8460.4977,0.0274
24,27,51,Co,8193.2549,0.9498
33,19,52,K,8115.0303,0.6449
32,20,52,Ca,8429.3821,0.0129
31,21,52,Sc,8534.6695,0.0591
30,22,52,Ti,8691.8193,0.0528
29,23,52,V,8714.569,0.0031
28,24,52,Cr,8775.9946,0.0022
27,25,52,Mn,8670.4087,0.0025
26,26,52,Fe,8609.6079,0.0035
25,27,52,Co,8325.5606,0.1016
24,28,52,Ni,8083.8977,1.5943
34,19,53,K,8022.8488,2.109
33,20,53,Ca,8330.5778,0.826
32,21,53,Sc,8492.8325,0.3339
31,22,53,Ti,8631.1256,0.0545
30,23,53,V,8710.1425,0.0585
29,24,53,Cr,8760.2103,0.0022
28,25,53,Mn,8734.1798,0.0065
27,26,53,Fe,8648.7985,0.0315
26,27,53,Co,8477.6578,0.0326
25,28,53,Ni,8217.0749,0.4745
34,20,54,Ca,8247.4967,0.897
33,21,54,Sc,8404.8115,0.2588
32,22,54,Ti,8599.6917,0.2932
31,23,54,V,8662.1382,0.207
30,24,54,Cr,8777.9672,0.0025
29,25,54,Mn,8737.9768,0.0186
28,26,54,Fe,8736.3846,0.0064
27,27,54,Co,8569.2199,0.0066
26,28,54,Ni,8393.0328,0.0862
35,20,55,Ca,8125.926,2.913
34,21,55,Sc,8333.3694,1.1347
33,22,55,Ti,8518.9696,0.525
32,23,55,V,8637.3391,0.4912
31,24,55,Cr,8731.9362,0.0042
30,25,55,Mn,8765.0247,0.0047
29,26,55,Fe,8746.5981,0.0056
28,27,55,Co,8669.6204,0.0074
27,28,55,Ni,8497.3225,0.0128
26,29,55,Cu,8233.997,2.8284
36,20,56,Ca,8033.1654,4.4579
35,21,56,Sc,8233.5781,4.6369
34,22,56,Ti,8467.9495,1.7893
33,23,56,V,8574.7006,3.1408
32,24,56,Cr,8723.2609,0.0103
31,25,56,Mn,8738.3358,0.0052
30,26,56,Fe,8790.3563,0.0048
29,27,56,Co,8694.8386,0.0085
28,28,56,Ni,8642.7811,0.0071
27,29,56,Cu,8355.9907,0.1142
36,21,57,Sc,8158.1666,3.154
35,22,57,Ti,8372.9008,3.6119
34,23,57,V,8535.1967,1.4871
33,24,57,Cr,8663.3998,0.0327
32,25,57,Mn,8736.7146,0.0264
31,26,57,Fe,8770.2829,0.0047
30,27,57,Co,8741.8845,0.009
29,28,57,Ni,8670.9364,0.0099
28,29,57,Cu,8503.2646,0.0088
37,21,58,Sc,8054.9436,3.2763
36,22,58,Ti,8307.629,3.161
35,23,58,V,8458.156,1.652
34,24,58,Cr,8643.9987,0.0514
33,25,58,Mn,8696.6438,0.0466
32,26,58,Fe,8792.2534,0.0055
31,27,58,Co,8738.9719,0.0199
30,28,58,Ni,8732.0621,0.006
29,29,58,Cu,8570.9696,0.0097
28,30,58,Zn,8395.9467,0.8621
38,21,59,Sc,7976.4073,4.2312
36,23,59,V,8403.8034,2.3288
35,24,59,Cr,8568.5995,0.0114
34,25,59,Mn,8680.9224,0.0395
33,26,59,Fe,8754.7746,0.0056
32,27,59,Co,8768.0379,0.0067
31,28,59,Ni,8736.5912,0.006
30,29,59,Cu,8642.0027,0.009
29,30,59,Zn,8473.7802,0.0129
38,22,60,Ti,8152.7858,4.0054
37,23,60,V,8322.8751,3.0324
36,24,60,Cr,8540.1876,0.0186
35,25,60,Mn,8628.1392,0.0388
34,26,60,Fe,8755.8539,0.0568
33,27,60,Co,8746.7692,0.0067
32,28,60,Ni,8780.7769,0.0059
31,29,60,Cu,8665.6047,0.0269
30,30,60,Zn,8583.0524,0.0091
38,23,61,V,8271.0417,3.8511
37,24,61,Cr,8460.1734,0.0305
36,25,61,Mn,8598.9157,0.0382
35,26,61,Fe,8703.7686,0.0428
34,27,61,Co,8756.151,0.0138
33,28,61,Ni,8765.0281,0.0058
32,29,61,Cu,8715.5148,0.0156
31,30,61,Zn,8610.3098,0.2606
30,31,61,Ga,8446.4313,0.6228
39,23,62,V,8187.7565,4.2627
38,24,62,Cr,8427.3871,0.0556
37,25,62,Mn,8538.5002,0.1055
36,26,62,Fe,8692.8831,0.0451
35,27,62,Co,8721.3347,0.2996
34,28,62,Ni,8794.5555,0.0069
33,29,62,Cu,8718.0839,0.0103
32,30,62,Zn,8679.3451,0.0099
31,31,62,Ga,8518.6449,0.0103
40,23,63,V,8130.7809,5.3968
39,24,63,Cr,8347.5398,1.1533
38,25,63,Mn,8505.102,0.0591
37,26,63,Fe,8631.5499,0.0683
36,27,63,Co,8717.7972,0.2948
35,28,63,Ni,8763.4955,0.0068
34,29,63,Cu,8752.1404,0.0068
33,30,63,Zn,8686.2866,0.0248
32,31,63,Ga,8583.9267,0.0207
31,32,63,Ge,8418.7167,0.5914
40,24,64,Cr,8303.5626,4.6866
39,25,64,Mn,8437.4175,0.0553
38,26,64,Fe,8612.3888,0.0784
37,27,64,Co,8675.5223,0.3126
36,28,64,Ni,8777.4637,0.0072
35,29,64,Cu,8739.0736,0.0067
34,30,64,Zn,8735.9057,0.0101
33,31,64,Ga,8611.6317,0.0223
32,32,64,Ge,8528.8243,0.0582
40,25,65,Mn,8400.6822,0.0573
39,26,65,Fe,8546.347,0.0786
38,27,65,Co,8656.8848,0.032
37,28,65,Ni,8736.2424,0.0074
36,29,65,Cu,8757.0967,0.0099
35,30,65,Zn,8724.266,0.0099
34,31,65,Ga,8662.1601,0.0122
33,32,65,Ge,8555.0584,0.0333
32,33,65,As,8396.2351,1.3041
41,25,66,Mn,8331.7986,0.1694
40,26,66,Fe,8521.7245,0.0621
39,27,66,Co,8605.9419,0.2117
38,28,66,Ni,8739.5086,0.0212
37,29,66,Cu,8731.473,0.0098
36,30,66,Zn,8759.6335,0.0113
35,31,66,Ga,8669.3631,0.0166
34,32,66,Ge,8625.4383,0.0364
33,33,66,As,8468.4034,0.0861
41,26,67,Fe,8449.9359,0.057
40,27,67,Co,8581.7422,0.0962
39,28,67,Ni,8695.7505,0.0431
38,29,67,Cu,8737.4597,0.0133
37,30,67,Zn,8734.1534,0.0113
36,31,67,Ga,8707.533,0.0176
35,32,67,Ge,8633.0884,0.0645
34,33,67,As,8530.5685,0.0066
33,34,67,Se,8369.5344,1.001
41,27,68,Co,8520.1301,0.0567
40,28,68,Ni,8682.4667,0.0438
39,29,68,Cu,8701.8913,0.0233
38,30,68,Zn,8755.682,0.0115
37,31,68,Ga,8701.2195,0.021
36,32,68,Ge,8688.1371,0.0276
35,33,68,As,8557.7457,0.0271
34,34,68,Se,8477.0482,0.0073
42,27,69,Co,8495.4062,1.242
41,28,69,Ni,8623.0998,0.054
40,29,69,Cu,8695.2044,0.0203
39,30,69,Zn,8722.7311,0.0115
38,31,69,Ga,8724.5798,0.0174
37,32,69,Ge,8680.964,0.0191
36,33,69,As,8611.8214,0.4638
35,34,69,Se,8503.7082,0.0216
34,35,69,Br,8344.9026,0.6087
43,27,70,Co,8434.198,0.157
42,28,70,Ni,8604.2917,0.0306
41,29,70,Cu,8646.8655,0.0155
40,30,70,Zn,8729.8086,0.0274
39,31,70,Ga,8709.2808,0.0172
38,32,70,Ge,8721.7028,0.0117
37,33,70,As,8621.5541,0.02
36,34,70,Se,8576.0338,0.0226
35,35,70,Br,8414.7964,0.2129
44,27,71,Co,8398.7344,6.5497
43,28,71,Ni,8543.1564,0.0315
42,29,71,Cu,8635.0233,0.021
41,30,71,Zn,8689.0417,0.0374
40,31,71,Ga,8717.605,0.0114
39,32,71,Ge,8703.3118,0.0115
38,33,71,As,8663.935,0.0586
37,34,71,Se,8586.0606,0.0394
36,35,71,Br,8481.4629,0.0761
35,36,71,Kr,8327.131,1.8136
44,28,72,Ni,8520.2118,0.0311
43,29,72,Cu,8586.5256,0.0194
42,30,72,Zn,8691.8053,0.0298
41,31,72,Ga,8687.0893,0.0114
40,32,72,Ge,8731.7459,0.0011
39,33,72,As,8660.3786,0.0567
38,34,72,Se,8644.4902,0.0272
37,35,72,Br,8511.3126,0.0142
36,36,72,Kr,8429.3193,0.1113
45,28,73,Ni,8457.6529,0.0332
44,29,73,Cu,8568.5699,0.0266
43,30,73,Zn,8648.3455,0.0255
42,31,73,Ga,8693.874,0.023
41,32,73,Ge,8705.05,0.0008
40,33,73,As,8689.6099,0.0528
39,34,73,Se,8641.5591,0.1017
38,35,73,Br,8568.0803,0.0923
37,36,73,Kr,8460.1847,0.0901
36,37,73,Rb,8305.0821,0.5588
45,29,74,Cu,8521.5633,0.0831
44,30,74,Zn,8642.7547,0.034
43,31,74,Ga,8663.1676,0.0405
42,32,74,Ge,8725.2011,0.0003
41,33,74,As,8680.002,0.0229
40,34,74,Se,8687.7155,0.0003
39,35,74,Br,8583.5615,0.0789
38,36,74,Kr,8533.039,0.0272
37,37,74,Rb,8381.7123,0.0409
46,29,75,Cu,8495.0801,0.0096
45,30,75,Zn,8592.4981,0.0261
44,31,75,Ga,8660.7565,0.0089
43,32,75,Ge,8695.6096,0.0007
42,33,75,As,8700.8748,0.0118
41,34,75,Se,8678.9139,0.001
40,35,75,Br,8627.6497,0.0571
39,36,75,Kr,8553.4399,0.1081
38,37,75,Rb,8448.2762,0.0157
37,38,75,Sr,8296.5116,2.9334
47,29,76,Cu,8443.6018,0.012
46,30,76,Zn,8582.2735,0.0192
45,31,76,Ga,8624.5272,0.0257
44,32,76,Ge,8705.2364,0.0003
43,33,76,As,8682.8172,0.0117
42,34,76,Se,8711.4781,0.0003
41,35,76,Br,8635.883,0.1227
40,36,76,Kr,8608.8077,0.0528
39,37,76,Rb,8486.2161,0.0123
38,38,76,Sr,8393.9294,0.4535
48,29,77,Cu,8411.2501,0.0157
47,30,77,Zn,8530.0037,0.0256
46,31,77,Ga,8613.3907,0.0315
45,32,77,Ge,8671.0293,0.0007
44,33,77,As,8695.9789,0.022
43,34,77,Se,8694.6908,0.0008
42,35,77,Br,8666.8073,0.0365
41,36,77,Kr,8616.837,0.0254
40,37,77,Rb,8537.3396,0.0169
39,38,77,Sr,8435.9188,0.1028
49,29,78,Cu,8354.6695,0.1709
48,30,78,Zn,8507.38,0.0249
47,31,78,Ga,8577.1043,0.0135
46,32,78,Ge,8671.6636,0.0453
45,33,78,As,8673.876,0.1254
44,34,78,Se,8717.8072,0.0023
43,35,78,Br,8661.9594,0.0459
42,36,78,Kr,8661.2385,0.0039
41,37,78,Rb,8558.3512,0.0415
40,38,78,Sr,8500.0971,0.0955
50,29,79,Cu,8320.938,1.3289
49,30,79,Zn,8450.5825,0.0282
48,31,79,Ga,8556.0725,0.0153
47,32,79,Ge,8634.5089,0.4704
46,33,79,As,8676.6172,0.0674
45,34,79,Se,8695.5923,0.0028
44,35,79,Br,8687.5956,0.0127
43,36,79,Kr,8657.113,0.0441
42,37,79,Rb,8601.1401,0.0246
41,38,79,Sr,8523.8558,0.0939
40,39,79,Y,8416.7788,1.014
50,30,80,Zn,8423.5457,0.0323
49,31,80,Ga,8508.4545,0.0361
48,32,80,Ge,8627.5707,0.0257
47,33,80,As,8651.2824,0.0417
46,34,80,Se,8710.8142,0.0118
45,35,80,Br,8677.6541,0.0124
44,36,80,Kr,8692.9301,0.0087
43,37,80,Rb,8611.676,0.0233
42,38,80,Sr,8578.5966,0.0433
41,39,80,Y,8454.2759,0.078
51,30,81,Zn,8351.9262,0.0621
50,31,81,Ga,8483.3576,0.0403
49,32,81,Ge,8580.6587,0.0254
48,33,81,As,8648.0571,0.0326
47,34,81,Se,8685.9998,0.0121
46,35,81,Br,8695.9465,0.0121
45,36,81,Kr,8682.8206,0.0133
44,37,81,Rb,8645.5139,0.0605
43,38,81,Sr,8587.3545,0.0386
42,39,81,Y,8505.9031,0.0667
41,40,81,Zr,8395.1519,1.1385
52,30,82,Zn,8301.1175,0.0375
51,31,82,Ga,8421.0494,0.0296
50,32,82,Ge,8563.7567,0.0273
49,33,82,As,8611.4153,0.0455
48,34,82,Se,8693.1973,0.0057
47,35,82,Br,8682.4953,0.0118
46,36,82,Kr,8710.6754,0.0003
45,37,82,Rb,8647.4275,0.0367
44,38,82,Sr,8635.719,0.0731
43,39,82,Y,8529.2762,0.0671
42,40,82,Zr,8465.4666,0.0193
52,31,83,Ga,8372.5756,0.0315
51,32,83,Ge,8504.3462,0.0292
50,33,83,As,8599.654,0.0337
49,34,83,Se,8658.556,0.0366
48,35,83,Br,8693.3852,0.0457
47,36,83,Kr,8695.7295,0.0003
46,37,83,Rb,8675.2193,0.0281
45,38,83,Sr,8638.4076,0.0823
44,39,83,Y,8573.6571,0.2245
43,40,83,Zr,8488.3997,0.0775
42,41,83,Nb,8378.9889,1.9528
53,31,84,Ga,8307.525,0.3549
52,32,84,Ge,8465.5244,0.0377
51,33,84,As,8547.9385,0.0377
50,34,84,Se,8658.7935,0.0233
49,35,84,Br,8671.3294,0.3063
48,36,84,Kr,8717.4473,0.0003
47,37,84,Rb,8676.2244,0.0261
46,38,84,Sr,8677.5132,0.0148
45,39,84,Y,8587.7812,0.0512
44,40,84,Zr,8549.0301,0.0655
43,41,84,Nb,8417.9563,0.0048
54,31,85,Ga,8253.5687,0.4384
53,32,85,Ge,8401.7689,0.0439
52,33,85,As,8510.9851,0.0362
51,34,85,Se,8610.3045,0.0307
50,35,85,Br,8673.5926,0.0362
49,36,85,Kr,8698.5633,0.0235
48,37,85,Rb,8697.4416,0.0003
47,38,85,Sr,8675.7193,0.0331
46,39,85,Y,8628.1486,0.2231
45,40,85,Zr,8564.0394,0.0756
44,41,85,Nb,8473.7117,0.0482
43,42,85,Mo,8361.332,0.1863
54,32,86,Ge,8354.63,5.0907
53,33,86,As,8456.7215,0.0401
52,34,86,Se,8581.8224,0.0293
51,35,86,Br,8632.3659,0.0358
50,36,86,Kr,8712.0295,0.0003
49,37,86,Rb,8696.9014,0.0023
48,38,86,Sr,8708.4566,0.0003
47,39,86,Y,8638.4293,0.1644
46,40,86,Zr,8614.0523,0.0415
45,41,86,Nb,8502.2231,0.0639
44,42,86,Mo,8434.7175,0.0341
54,33,87,As,8413.8521,0.0343
53,34,87,Se,8529.092,0.0258
52,35,87,Br,8605.9105,0.0364
51,36,87,Kr,8675.284,0.0028
50,37,87,Rb,8710.9843,0.0003
49,38,87,Sr,8705.2363,0.0003
48,39,87,Y,8674.8451,0.013
47,40,87,Zr,8623.6545,0.0477
46,41,87,Nb,8551.7579,0.0782
45,42,87,Mo,8462.4243,0.0328
44,43,87,Tc,8347.7449,0.0482
54,34,88,Se,8495.0045,0.0382
53,35,88,Br,8563.7479,0.036
52,36,88,Kr,8656.8499,0.0296
51,37,88,Rb,8681.1154,0.0018
50,38,88,Sr,8732.5958,0.0003
49,39,88,Y,8682.5396,0.017
48,40,88,Zr,8666.0339,0.0614
47,41,88,Nb,8572.4013,0.6569
46,42,88,Mo,8523.9087,0.0434
45,43,88,Tc,8389.8338,0.0466
55,34,89,Se,8435.2799,0.0419
54,35,89,Br,8530.7802,0.0367
53,36,89,Kr,8614.8158,0.0241
52,37,89,Rb,8664.1895,0.061
51,38,89,Sr,8705.923,0.0011
50,39,89,Y,8714.011,0.0038
49,40,89,Zr,8673.3865,0.0312
48,41,89,Nb,8616.8184,0.2655
47,42,89,Mo,8544.9851,0.044
46,43,89,Tc,8450.5758,0.0429
45,44,89,Ru,8340.376,0.2721
56,34,90,Se,8395.7672,3.6639
55,35,90,Br,8478.1865,0.0373
54,36,90,Kr,8591.2599,0.0207
53,37,90,Rb,8631.5262,0.0717
52,38,90,Sr,8696.0043,0.0161
51,39,90,Y,8693.3778,0.0039
50,40,90,Zr,8709.9699,0.0013
49,41,90,Nb,8633.377,0.0369
48,42,90,Mo,8597.0285,0.0385
47,43,90,Tc,8483.36,0.0114
46,44,90,Ru,8409.7684,0.0414
57,34,91,Se,8334.8382,4.7598
56,35,91,Br,8441.9242,0.0389
55,36,91,Kr,8541.7519,0.0246
54,37,91,Rb,8607.5621,0.0857
53,38,91,Sr,8663.8759,0.0599
52,39,91,Y,8684.9421,0.0203
51,40,91,Zr,8693.3149,0.0011
50,41,91,Nb,8670.8983,0.0322
49,42,91,Mo,8613.6286,0.0686
48,43,91,Tc,8536.6558,0.026
47,44,91,Ru,8442.9287,0.0244
57,35,92,Br,8384.9123,0.0729
56,36,92,Kr,8512.675,0.0294
55,37,92,Rb,8569.4225,0.0666
54,38,92,Sr,8648.907,0.0372
53,39,92,Y,8661.5894,0.0992
52,40,92,Zr,8692.6783,0.0011
51,41,92,Nb,8662.3731,0.0194
50,42,92,Mo,8657.7312,0.0017
49,43,92,Tc,8563.544,0.0337
48,44,92,Ru,8504.774,0.0295
47,45,92,Rh,8373.4211,0.0476
46,46,92,Pd,8275.5695,3.7503
58,35,93,Br,8345.5986,4.6324
57,36,93,Kr,8458.1085,0.027
56,37,93,Rb,8540.9209,0.0842
55,38,93,Sr,8612.7875,0.0812
54,39,93,Y,8648.9054,0.1128
53,40,93,Zr,8671.6207,0.0049
52,41,93,Nb,8664.1849,0.016
51,42,93,Mo,8651.4095,0.002
50,43,93,Tc,8608.5782,0.0109
49,44,93,Ru,8531.4627,0.0222
48,45,93,Rh,8434.8255,0.0283
47,46,93,Pd,8318.5637,3.9786
58,36,94,Kr,8424.3318,0.1288
57,37,94,Rb,8492.7644,0.0216
56,38,94,Sr,8593.8344,0.0177
55,39,94,Y,8622.8068,0.0679
54,40,94,Zr,8666.8016,0.0018
53,41,94,Nb,8648.9014,0.0159
52,42,94,Mo,8662.3341,0.0015
51,43,94,Tc,8608.7373,0.0433
50,44,94,Ru,8583.662,0.0334
49,45,94,Rh,8472.4033,0.0359
48,46,94,Pd,8391.6832,0.0456
59,36,95,Kr,8365.9963,0.1961
58,37,95,Rb,8460.1967,0.2131
57,38,95,Sr,8549.0875,0.0612
56,39,95,Y,8604.9644,0.0714
55,40,95,Zr,8643.5924,0.0092
54,41,95,Nb,8647.2133,0.0054
53,42,95,Mo,8648.7212,0.0013
52,43,95,Tc,8622.6911,0.0535
51,44,95,Ru,8587.4706,0.1
50,45,95,Rh,8525.3707,0.0409
49,46,95,Pd,8428.9807,0.0319
60,36,96,Kr,8330.8721,0.2008
59,37,96,Rb,8408.8963,0.0349
58,38,96,Sr,8521.2041,0.0882
57,39,96,Y,8569.4269,0.0633
56,40,96,Zr,8635.3283,0.0012
55,41,96,Nb,8628.8868,0.0015
54,42,96,Mo,8653.988,0.0013
53,43,96,Tc,8614.8673,0.0536
52,44,96,Ru,8609.413,0.0018
51,45,96,Rh,8534.6735,0.1042
50,46,96,Pd,8490.0207,0.0437
49,47,96,Ag,8360.2903,0.9384
61,36,97,Kr,8269.8645,1.3444
60,37,97,Rb,8376.1872,0.0197
59,38,97,Sr,8471.8489,0.0349
58,39,97,Y,8541.4616,0.0692
57,40,97,Zr,8603.7182,0.0013
56,41,97,Nb,8623.1384,0.0438
55,42,97,Mo,8635.0926,0.0017
54,43,97,Tc,8623.7254,0.0425
53,44,97,Ru,8604.2799,0.0285
52,45,97,Rh,8559.8949,0.3656
51,46,97,Pd,8502.4303,0.0499
50,47,97,Ag,8423.2121,0.1239
49,48,97,Cd,8310.3013,4.3317
61,37,98,Rb,8330.7294,0.1641
60,38,98,Sr,8445.7385,0.0329
59,39,98,Y,8497.6162,0.0808
58,40,98,Zr,8581.3984,0.0862
57,41,98,Nb,8596.3016,0.051
56,42,98,Mo,8635.1691,0.0018
55,43,98,Tc,8610.0047,0.0345
54,44,98,Ru,8620.314,0.0659
53,45,98,Rh,8560.8038,0.1215
52,46,98,Pd,8533.8999,0.0484
51,47,98,Ag,8441.6866,0.3358
50,48,98,Cd,8378.2953,0.5285
62,37,99,Rb,8295.301,0.0407
61,38,99,Sr,8402.5235,0.0479
60,39,99,Y,8476.6938,0.0668
59,40,99,Zr,8539.225,0.1061
58,41,99,Nb,8578.9859,0.1213
57,42,99,Mo,8607.7982,0.0023
56,43,99,Tc,8613.6105,0.0092
55,44,99,Ru,8608.7132,0.0035
54,45,99,Rh,8580.1959,0.1965
53,46,99,Pd,8537.9332,0.0516
52,47,99,Ag,8474.7744,0.0633
51,48,99,Cd,8398.3734,0.016
63,37,100,Rb,8244.5085,0.1312
62,38,100,Sr,8372.2012,0.0692
61,39,100,Y,8439.4151,0.1118
60,40,100,Zr,8522.1066,0.0814
59,41,100,Nb,8548.4683,0.0798
58,42,100,Mo,8604.6626,0.003
57,43,100,Tc,8595.1184,0.0135
56,44,100,Ru,8619.3593,0.0034
55,45,100,Rh,8575.1732,0.1813
54,46,100,Pd,8563.5652,0.1764
53,47,100,Ag,8484.9947,0.05
52,48,100,Cd,8437.7375,0.0168
51,49,100,In,8329.7495,0.0224
50,50,100,Sn,8251.626,2.4001
64,37,101,Rb,8206.1753,0.2029
63,38,101,Sr,8324.7411,0.084
62,39,101,Y,8413.3305,0.0701
61,40,101,Zr,8485.8439,0.0825
60,41,101,Nb,8534.8355,0.0371
59,42,101,Mo,8572.9159,0.0031
58,43,101,Tc,8593.1366,0.2377
57,44,101,Ru,8601.366,0.0041
56,45,101,Rh,8588.2172,0.0578
55,46,101,Pd,8560.8644,0.0454
54,47,101,Ag,8512.5465,0.0479
53,48,101,Cd,8450.3657,0.0148
52,49,101,In,8370.426,0.1155
51,50,101,Sn,8281.103,2.9703
65,37,102,Rb,8152.7443,0.8128
64,38,102,Sr,8291.2213,0.6575
63,39,102,Y,8371.9172,0.04
62,40,102,Zr,8466.294,0.0859
61,41,102,Nb,8504.8675,0.0246
60,42,102,Mo,8568.3994,0.0814
59,43,102,Tc,8570.6514,0.0899
58,44,102,Ru,8607.4275,0.0041
57,45,102,Rh,8576.9818,0.0628
56,46,102,Pd,8580.2887,0.0041
55,47,102,Ag,8517.165,0.0801
54,48,102,Cd,8484.1322,0.0163
53,49,102,In,8388.5719,0.0448
52,50,102,Sn,8324.4313,0.9814
64,39,103,Y,8342.6336,0.1088
63,40,103,Zr,8425.8337,0.0895
62,41,103,Nb,8488.332,0.0382
61,42,103,Mo,8538.2672,0.0895
60,43,103,Tc,8566.1045,0.0952
59,44,103,Ru,8584.3656,0.0043
58,45,103,Rh,8584.1927,0.0223
57,46,103,Pd,8571.0173,0.0085
56,47,103,Ag,8537.652,0.0398
55,48,103,Cd,8489.7547,0.0176
54,49,103,In,8423.7199,0.0872
64,40,104,Zr,8402.3159,0.0896
63,41,104,Nb,8453.3832,0.0172
62,42,104,Mo,8527.9063,0.0857
61,43,104,Tc,8541.107,0.2393
60,44,104,Ru,8587.3998,0.024
59,45,104,Rh,8568.9501,0.0221
58,46,104,Pd,8584.8485,0.0129
57,47,104,Ag,8536.185,0.0406
56,48,104,Cd,8517.6232,0.0161
55,49,104,In,8435.238,0.0555
54,50,104,Sn,8383.9114,0.0552
52,52,104,Te,8157.3256,3.0539
65,40,105,Zr,8358.598,0.1153
64,41,105,Nb,8431.6925,0.0384
63,42,105,Mo,8494.863,0.0862
62,43,105,Tc,8534.6074,0.3358
61,44,105,Ru,8561.9016,0.0238
60,45,105,Rh,8572.7053,0.0238
59,46,105,Pd,8570.6509,0.0108
58,47,105,Ag,8550.3708,0.0433
57,48,105,Cd,8516.8532,0.0133
56,49,105,In,8464.7045,0.0976
55,50,105,Sn,8397.229,0.0378
54,51,105,Sb,8300.9923,0.2079
53,52,105,Te,8186.8368,2.8573
65,41,106,Nb,8393.2657,0.0134
64,42,106,Mo,8479.5202,0.0861
63,43,106,Tc,8506.557,0.1156
62,44,106,Ru,8560.9406,0.0509
61,45,106,Rh,8553.9317,0.0508
60,46,106,Pd,8579.9934,0.0104
59,47,106,Ag,8544.6397,0.0285
58,48,106,Cd,8539.0492,0.0104
57,49,106,In,8470.1213,0.1153
56,50,106,Sn,8432.0383,0.048
55,51,106,Sb,8322.0124,0.0703
54,52,106,Te,8236.7682,0.9485
66,41,107,Nb,8367.0898,0.075
65,42,107,Mo,8442.219,0.0862
64,43,107,Tc,8492.8979,0.0811
63,44,107,Ru,8533.3676,0.0811
62,45,107,Rh,8554.104,0.1126
61,46,107,Pd,8560.8946,0.0112
60,47,107,Ag,8553.9012,0.0223
59,48,107,Cd,8533.3524,0.0155
58,49,107,In,8494.0439,0.0902
57,50,107,Sn,8439.4946,0.0496
56,51,107,Sb,8358.7344,0.0388
67,41,108,Nb,8325.6604,0.0763
66,42,108,Mo,8422.1581,0.0854
65,43,108,Tc,8462.8172,0.0812
64,44,108,Ru,8527.2267,0.0804
63,45,108,Rh,8532.6657,0.1296
62,46,108,Pd,8567.0241,0.0103
61,47,108,Ag,8542.0262,0.0221
60,48,108,Cd,8550.0196,0.0104
59,49,108,In,8495.2516,0.08
58,50,108,Sn,8469.0273,0.0498
57,51,108,Sb,8372.6666,0.0509
56,52,108,Te,8303.7221,0.0501
54,54,108,Xe,8074.8886,3.5139
68,41,109,Nb,8297.1307,3.9524
67,42,109,Mo,8381.4163,0.1026
66,43,109,Tc,8444.1796,0.0887
65,44,109,Ru,8496.228,0.0821
64,45,109,Rh,8528.1404,0.0371
63,46,109,Pd,8544.8825,0.0102
62,47,109,Ag,8547.9155,0.0118
61,48,109,Cd,8538.7646,0.0141
60,49,109,In,8513.1027,0.0364
59,50,109,Sn,8470.5183,0.0729
58,51,109,Sb,8404.8161,0.0483
57,52,109,Te,8319.3305,0.0402
56,53,109,I,8220.0164,0.0617
55,54,109,Xe,8107.3071,2.7533
69,41,110,Nb,8255.2607,7.6213
68,42,110,Mo,8359.293,0.2202
67,43,110,Tc,8411.2603,0.0863
66,44,110,Ru,8486.3123,0.0811
65,45,110,Rh,8504.2551,0.1619
64,46,110,Pd,8547.163,0.0056
63,47,110,Ag,8532.1089,0.0117
62,48,110,Cd,8551.2755,0.0035
61,49,110,In,8508.9087,0.105
60,50,110,Sn,8496.0875,0.1252
59,51,110,Sb,8412.6821,0.0542
58,52,110,Te,8358.116,0.0598
57,53,110,I,8244.0767,0.5631
56,54,110,Xe,8159.2808,0.9181
69,42,111,Mo,8315.2932,0.1133
68,43,111,Tc,8390.0906,0.0953
67,44,111,Ru,8452.9582,0.0872
66,45,111,Rh,8495.6267,0.0617
65,46,111,Pd,8521.7498,0.0066
64,47,111,Ag,8534.7878,0.0131
63,48,111,Cd,8537.0801,0.0032
62,49,111,In,8522.2824,0.0308
61,50,111,Sn,8493.131,0.0481
60,51,111,Sb,8440.1203,0.0797
59,52,111,Te,8367.7635,0.0579
58,53,111,I,8282.9343,0.0428
69,43,112,Tc,8353.6217,0.0492
68,44,112,Ru,8439.2431,0.0857
67,45,112,Rh,8468.8666,0.3936
66,46,112,Pd,8520.7205,0.0584
65,47,112,Ag,8516.0807,0.0216
64,48,112,Cd,8544.7306,0.0022
63,49,112,In,8514.6674,0.038
62,50,112,Sn,8513.6189,0.0026
61,51,112,Sb,8443.633,0.1592
60,52,112,Te,8400.6527,0.0749
59,53,112,I,8299.8801,0.0915
58,54,112,Xe,8230.0646,0.074
70,43,113,Tc,8329.4652,0.0297
69,44,113,Ru,8402.6857,0.3388
68,45,113,Rh,8456.8165,0.0631
67,46,113,Pd,8492.5795,0.0615
66,47,113,Ag,8516.066,0.1473
65,48,113,Cd,8526.9874,0.0022
64,49,113,In,8522.9297,0.0017
63,50,113,Sn,8506.8117,0.0139
62,51,113,Sb,8465.2762,0.1521
61,52,113,Te,8404.6366,0.2473
60,53,113,I,8333.7528,0.0709
59,54,113,Xe,8247.9277,0.0605
58,55,113,Cs,8148.623,0.0759
71,43,114,Tc,8290.2599,3.7995
70,44,114,Ru,8385.3351,0.0312
69,45,114,Rh,8426.6221,0.6277
68,46,114,Pd,8488.0056,0.061
67,47,114,Ag,8493.7786,0.04
66,48,114,Cd,8531.5135,0.0024
65,49,114,In,8511.9742,0.0027
64,50,114,Sn,8522.5671,0.0004
63,51,114,Sb,8462.5191,0.1734
62,52,114,Te,8432.7885,0.2143
61,53,114,I,8344.779,0.1757
60,54,114,Xe,8289.2054,0.0981
59,55,114,Cs,8173.5711,0.7462
58,56,114,Ba,8089.6865,0.9007
71,44,115,Ru,8346.814,0.2188
70,45,115,Rh,8410.6538,0.0636
69,46,115,Pd,8457.7342,0.1178
68,47,115,Ag,8490.5553,0.1589
67,48,115,Cd,8510.7252,0.0057
66,49,115,In,8516.5472,0.0003
65,50,115,Sn,8514.0702,0.0003
64,51,115,Sb,8480.9156,0.1394
63,52,115,Te,8431.1504,0.243
62,53,115,I,8374.5651,0.2511
61,54,115,Xe,8300.9704,0.1053
72,44,116,Ru,8326.884,0.0321
71,45,116,Rh,8377.6123,0.6365
70,46,116,Pd,8449.2755,0.0615
69,47,116,Ag,8465.9073,0.0281
68,48,116,Cd,8512.3511,0.0014
67,49,116,In,8501.6177,0.0019
66,50,116,Sn,8523.1166,0.0009
65,51,116,Sb,8475.8208,0.0444
64,52,116,Te,8455.6435,0.2087
63,53,116,I,8381.2858,0.6469
62,54,116,Xe,8336.8365,0.1122
73,44,117,Ru,8285.5625,3.7021
72,45,117,Rh,8359.2766,0.076
71,46,117,Pd,8416.9243,0.062
70,47,117,Ag,8459.4515,0.116
69,48,117,Cd,8488.974,0.0087
68,49,117,In,8503.8653,0.0417
67,50,117,Sn,8509.612,0.0041
66,51,117,Sb,8487.8981,0.0721
65,52,117,Te,8450.9203,0.115
64,53,117,I,8404.4307,0.2184
63,54,117,Xe,8344.2976,0.0887
62,55,117,Cs,8271.8652,0.5334
61,56,117,Ba,8187.9546,2.1396
73,45,118,Rh,8322.8539,0.2054
72,46,118,Pd,8405.2197,0.0211
71,47,118,Ag,8433.89,0.0213
70,48,118,Cd,8487.835,0.1695
69,49,118,In,8485.667,0.0657
68,50,118,Sn,8516.5341,0.0042
67,51,118,Sb,8478.9156,0.0256
66,52,118,Te,8469.697,0.1551
65,53,118,I,8406.1203,0.1675
64,54,118,Xe,8374.9819,0.088
63,55,118,Cs,8286.4053,0.1081
74,45,119,Rh,8303.3953,0.0783
73,46,119,Pd,8368.9594,0.0693
72,47,119,Ag,8423.2126,0.1236
71,48,119,Cd,8461.4381,0.3168
70,49,119,In,8486.1387,0.0614
69,50,119,Sn,8499.4494,0.0061
68,51,119,Sb,8487.9218,0.0588
67,52,119,Te,8462.0785,0.0612
66,53,119,I,8426.8924,0.1824
65,54,119,Xe,8378.442,0.0872
64,55,119,Cs,8317.3347,0.1171
63,56,119,Ba,8245.9287,1.6829
74,46,120,Pd,8357.0817,0.0191
73,47,120,Ag,8395.3281,0.0373
72,48,120,Cd,8458.024,0.0311
71,49,120,In,8466.2575,0.3334
70,50,120,Sn,8504.488,0.0077
69,51,120,Sb,8475.63,0.06
68,52,120,Te,8476.9857,0.0146
67,53,120,I,8423.6745,0.1258
66,54,120,Xe,8404.0322,0.0985
65,55,120,Cs,8328.4811,0.0831
64,56,120,Ba,8280.2949,2.5014
76,45,121,Rh,8245.2397,5.1194
75,46,121,Pd,8320.8584,0.0277
74,47,121,Ag,8382.3306,0.1001
73,48,121,Cd,8430.9972,0.0161
72,49,121,In,8463.8767,0.2266
71,50,121,Sn,8485.1964,0.0081
70,51,121,Sb,8482.0574,0.0207
69,52,121,Te,8466.8641,0.2135
68,53,121,I,8441.4111,0.039
67,54,121,Xe,8403.8326,0.0847
66,55,121,Cs,8352.9152,0.1181
65,56,121,Ba,8293.9083,1.1727
76,46,122,Pd,8305.9755,0.1603
75,47,122,Ag,8352.7591,0.313
74,48,122,Cd,8424.2667,0.0188
73,49,122,In,8442.1079,0.4103
72,50,122,Sn,8487.8968,0.0201
71,51,122,Sb,8468.3222,0.0205
70,52,122,Te,8478.1315,0.0111
69,53,122,I,8437.0139,0.0425
68,54,122,Xe,8424.6644,0.0911
67,55,122,Cs,8359.1515,0.2761
66,56,122,Ba,8323.7567,0.2291
77,46,123,Pd,8270.0318,6.4182
76,47,123,Ag,8337.9707,0.2651
75,48,123,Cd,8395.3955,0.0219
74,49,123,In,8437.9362,0.1612
73,50,123,Sn,8467.2313,0.0202
72,51,123,Sb,8472.3196,0.011
71,52,123,Te,8465.537,0.011
70,53,123,I,8449.1896,0.03
69,54,123,Xe,8420.9239,0.0775
68,55,123,Cs,8380.3796,0.0985
67,56,123,Ba,8330.2086,0.0985
77,47,124,Ag,8308.8958,2.0283
76,48,124,Cd,8387.0179,0.021
75,49,124,In,8414.3243,0.2465
74,50,124,Sn,8467.3997,0.0106
73,51,124,Sb,8456.1517,0.011
72,52,124,Te,8473.2705,0.0109
71,53,124,I,8441.4807,0.0185
70,54,124,Xe,8437.6138,0.011
69,55,124,Cs,8383.5114,0.0738
68,56,124,Ba,8355.8209,0.1008
67,57,124,La,8278.2926,0.457
78,47,125,Ag,8293.3151,3.4652
77,48,125,Cd,8357.6815,0.0231
76,49,125,In,8407.9365,0.0142
75,50,125,Sn,8445.5285,0.0106
74,51,125,Sb,8458.1612,0.0201
73,52,125,Te,8458.0361,0.0108
72,53,125,I,8450.2911,0.0108
71,54,125,Xe,8430.939,0.0113
70,55,125,Cs,8399.8033,0.0619
69,56,125,Ba,8358.1784,0.0879
68,57,125,La,8304.6438,0.208
78,48,126,Cd,8346.7393,0.0183
77,49,126,In,8384.6067,0.0333
76,50,126,Sn,8443.5227,0.0848
75,51,126,Sb,8440.3136,0.2528
74,52,126,Te,8463.2397,0.0107
73,53,126,I,8439.9379,0.03
72,54,126,Xe,8443.5375,0.0003
71,55,126,Cs,8399.2673,0.0822
70,56,126,Ba,8379.7187,0.0992
69,57,126,La,8312.4268,0.7183
68,58,126,Ce,8273.2581,0.2218
79,48,127,Cd,8316.8971,0.0488
78,49,127,In,8374.8212,0.0788
77,50,127,Sn,8420.5482,0.0726
76,51,127,Sb,8439.811,0.04
75,52,127,Te,8446.109,0.0108
74,53,127,I,8445.482,0.0285
73,54,127,Xe,8434.1066,0.0322
72,55,127,Cs,8411.5617,0.0439
71,56,127,Ba,8378.456,0.0894
70,57,127,La,8333.5412,0.2047
69,58,127,Ce,8280.7922,0.2274
80,48,128,Cd,8303.2367,0.0503
79,49,128,In,8351.4361,0.0103
78,50,128,Sn,8416.9749,0.1381
77,51,128,Sb,8420.7724,0.1468
76,52,128,Te,8448.7536,0.0055
75,53,128,I,8432.8309,0.0283
74,54,128,Xe,8443.3008,0.0003
73,55,128,Cs,8406.4953,0.042
72,56,128,Ba,8395.9878,0.0126
71,57,128,La,8337.1904,0.4254
70,58,128,Ce,8306.9259,0.2183
69,59,128,Pr,8228.9141,0.2329
81,48,129,Cd,8269.5311,0.0412
80,49,129,In,8338.759,0.0153
79,50,129,Sn,8392.8161,0.1339
78,51,129,Sb,8418.0598,0.1645
77,52,129,Te,8430.4098,0.0055
76,53,129,I,8435.9908,0.0244
75,54,129,Xe,8431.3904,0.0003
74,55,129,Cs,8416.0465,0.0353
73,56,129,Ba,8391.0811,0.0814
72,57,129,La,8356.0449,0.1655
71,58,129,Ce,8310.9411,0.2166
70,59,129,Pr,8254.3808,0.2311
82,48,130,Cd,8252.5868,0.172
81,49,130,In,8314.176,0.0138
80,50,130,Sn,8386.817,0.0144
79,51,130,Sb,8397.3641,0.1093
78,52,130,Te,8430.3251,0.0003
77,53,130,I,8421.1011,0.0243
76,54,130,Xe,8437.7314,0.0003
75,55,130,Cs,8408.7848,0.0643
74,56,130,Ba,8405.513,0.0022
73,57,130,La,8356.1919,0.1996
72,58,130,Ce,8333.2164,0.215
71,59,130,Pr,8263.7565,0.4944
70,60,130,Nd,8222.5136,0.215
83,48,131,Cd,8206.1204,0.1469
82,49,131,In,8297.9544,0.0168
81,50,131,Sn,8362.5183,0.0276
80,51,131,Sb,8392.5525,0.0159
79,52,131,Te,8411.2339,0.0005
78,53,131,I,8422.2977,0.0046
77,54,131,Xe,8423.7367,0.0003
76,55,131,Cs,8415.0317,0.0014
75,56,131,Ba,8398.5511,0.0032
74,57,131,La,8370.3676,0.2133
73,58,131,Ce,8333.3969,0.2504
72,59,131,Pr,8286.1439,0.3587
71,60,131,Nd,8230.3045,0.2101
84,48,132,Cd,8169.1421,0.4551
83,49,132,In,8253.7162,0.4548
82,50,132,Sn,8354.8726,0.015
81,51,132,Sb,8372.3452,0.0187
80,52,132,Te,8408.4859,0.0264
79,53,132,I,8406.4628,0.0308
78,54,132,Xe,8427.6229,0.0003
77,55,132,Cs,8405.5878,0.0079
76,56,132,Ba,8409.3747,0.008
75,57,132,La,8367.7559,0.2754
74,58,132,Ce,8352.3223,0.1546
73,59,132,Pr,8291.5377,0.2188
72,60,132,Nd,8256.8104,0.1834
83,50,133,Sn,8310.089,0.0143
82,51,133,Sb,8364.7302,0.0235
81,52,133,Te,8389.0255,0.0155
80,53,133,I,8405.0993,0.0444
79,54,133,Xe,8412.6477,0.018
78,55,133,Cs,8409.9786,0.0003
77,56,133,Ba,8400.2059,0.0075
76,57,133,La,8378.8415,0.2101
75,58,133,Ce,8349.8301,0.123
74,59,133,Pr,8310.2588,0.094
73,60,133,Nd,8262.232,0.3502
72,61,133,Pm,8204.2841,0.3782
84,50,134,Sn,8275.1719,0.0236
83,51,134,Sb,8325.9398,0.0229
82,52,134,Te,8383.6442,0.0205
81,53,134,I,8389.0722,0.0362
80,54,134,Xe,8413.6994,0.0003
79,55,134,Cs,8398.647,0.0003
78,56,134,Ba,8408.1731,0.0019
77,57,134,La,8374.4888,0.1487
76,58,134,Ce,8365.7716,0.1521
75,59,134,Pr,8312.8817,0.1516
74,60,134,Nd,8285.5391,0.0882
73,61,134,Pm,8213.4131,0.3128
85,50,135,Sn,8230.6877,0.0228
84,51,135,Sb,8291.9894,0.0196
83,52,135,Te,8345.7384,0.0128
82,53,135,I,8384.7609,0.0153
81,54,135,Xe,8398.4783,0.0272
80,55,135,Cs,8401.3393,0.0027
79,56,135,Ba,8397.5345,0.0018
78,57,135,La,8382.7972,0.0699
77,58,135,Ce,8361.9861,0.076
76,59,135,Pr,8328.9284,0.0875
75,60,135,Nd,8288.1536,0.1417
74,61,135,Pm,8236.7933,0.6141
73,62,135,Sm,8177.627,1.1454
85,51,136,Sb,8252.2533,0.0429
84,52,136,Te,8319.4301,0.0168
83,53,136,I,8351.3242,0.1043
82,54,136,Xe,8396.1889,0.0003
81,55,136,Cs,8389.7723,0.0138
80,56,136,Ba,8402.7566,0.0018
79,57,136,La,8376.0512,0.391
78,58,136,Ce,8373.7624,0.0024
77,59,136,Pr,8330.0089,0.0842
76,60,136,Nd,8308.5127,0.0869
75,61,136,Pm,8243.7207,0.5079
74,62,136,Sm,8205.9165,0.0919
86,51,137,Sb,8218.4764,0.3808
85,52,137,Te,8280.2357,0.0153
84,53,137,I,8326.0033,0.0612
83,54,137,Xe,8364.2865,0.0008
82,55,137,Cs,8388.9581,0.0022
81,56,137,Ba,8391.8288,0.0018
80,57,137,La,8381.8807,0.012
79,58,137,Ce,8367.2497,0.0026
78,59,137,Pr,8341.7074,0.0594
77,60,137,Nd,8309.5892,0.0856
76,61,137,Pm,8263.6516,0.0952
75,62,137,Sm,8213.5527,0.2089
74,63,137,Eu,8150.5738,0.032
86,52,138,Te,8252.5786,0.0274
85,53,138,I,8292.445,0.0432
84,54,138,Xe,8344.6913,0.0203
83,55,138,Cs,8360.1437,0.0664
82,56,138,Ba,8393.4222,0.0018
81,57,138,La,8375.0835,0.003
80,58,138,Ce,8377.0408,0.0036
79,59,138,Pr,8339.2195,0.0726
78,60,138,Nd,8325.4946,0.0841
77,61,138,Pm,8268.3558,0.0841
76,62,138,Sm,8237.9286,0.0856
75,63,138,Eu,8161.6211,0.2025
87,52,139,Te,8211.7716,0.0255
86,53,139,I,8265.61,0.0288
85,54,139,Xe,8311.5904,0.0154
84,55,139,Cs,8342.3397,0.0225
83,56,139,Ba,8367.0194,0.0018
82,57,139,La,8377.9987,0.0044
81,58,139,Ce,8370.4664,0.015
80,59,139,Pr,8349.5208,0.0263
79,60,139,Nd,8323.6642,0.198
78,61,139,Pm,8285.5473,0.0978
77,62,139,Sm,8243.0786,0.0783
76,63,139,Eu,8187.2187,0.0946
88,52,140,Te,8183.3567,0.1027
87,53,140,I,8229.474,0.0865
86,54,140,Xe,8290.8875,0.0166
85,55,140,Cs,8314.3227,0.0586
84,56,140,Ba,8353.15,0.0564
83,57,140,La,8355.0201,0.0043
82,58,140,Ce,8376.3045,0.0094
81,59,140,Pr,8346.5163,0.0439
80,60,140,Nd,8337.864,0.0233
79,61,140,Pm,8289.0958,0.173
78,62,140,Sm,8263.8211,0.0893
77,63,140,Eu,8197.733,0.3681
76,64,140,Gd,8154.9757,0.1996
75,65,140,Tb,8068.6732,5.7178
88,53,141,I,8202.2562,0.1123
87,54,141,Xe,8255.3647,0.0205
86,55,141,Cs,8294.3554,0.0652
85,56,141,Ba,8326.0774,0.0377
84,57,141,La,8343.205,0.0293
83,58,141,Ce,8355.3956,0.0093
82,59,141,Pr,8353.9852,0.0106
81,60,141,Nd,8335.5074,0.0226
80,61,141,Pm,8303.9405,0.0991
79,62,141,Sm,8265.846,0.0605
78,63,141,Eu,8217.6853,0.0896
77,64,141,Gd,8164.609,0.1401
76,65,141,Tb,8097.4761,0.7465
89,53,142,I,8165.2517,0.0348
88,54,142,Xe,8233.1695,0.019
87,55,142,Cs,8264.8777,0.0498
86,56,142,Ba,8310.9718,0.0417
85,57,142,La,8320.8263,0.0443
84,58,142,Ce,8347.07,0.0172
83,59,142,Pr,8336.3032,0.0106
82,60,142,Nd,8346.031,0.0088
81,61,142,Pm,8306.6587,0.1662
80,62,142,Sm,8285.9407,0.0131
79,63,142,Eu,8226.396,0.2117
78,64,142,Gd,8190.2569,0.1968
77,65,142,Tb,8111.508,4.9335
89,54,143,Xe,8196.8855,0.0326
88,55,143,Cs,8243.6707,0.053
87,56,143,Ba,8281.9878,0.0472
86,57,143,La,8306.1271,0.0513
85,58,143,Ce,8324.6765,0.0171
84,59,143,Pr,8329.428,0.0127
83,60,143,Nd,8330.4893,0.0088
82,61,143,Pm,8317.7341,0.0206
81,62,143,Sm,8288.1825,0.0192
80,63,143,Eu,8245.8177,0.0768
79,64,143,Gd,8198.3188,1.4007
78,65,143,Tb,8138.2176,0.3583
77,66,143,Dy,8075.0527,0.0912
90,54,144,Xe,8172.8845,0.0369
89,55,144,Cs,8211.8894,0.1398
88,56,144,Ba,8265.4549,0.0496
87,57,144,La,8281.4283,0.0898
86,58,144,Ce,8314.7612,0.0197
85,59,144,Pr,8311.5411,0.0188
84,60,144,Nd,8326.9237,0.0087
83,61,144,Pm,8305.2969,0.0202
82,62,144,Sm,8303.68,0.0101
81,63,144,Eu,8254.1744,0.0749
80,64,144,Gd,8221.9382,0.1941
79,65,144,Tb,8151.2877,0.1941
78,66,144,Dy,8105.5902,0.0498
77,67,144,Ho,8017.0977,0.0589
91,54,145,Xe,8135.0877,0.0771
90,55,145,Cs,8188.7342,0.0625
89,56,145,Ba,8234.7991,0.0585
88,57,145,La,8266.0873,0.0846
87,58,145,Ce,8289.8762,0.2338
86,59,145,Pr,8302.1285,0.0493
85,60,145,Nd,8309.1883,0.0088
84,61,145,Pm,8302.6583,0.0193
83,62,145,Sm,8293.0139,0.0102
82,63,145,Eu,8269.2744,0.0211
81,64,145,Gd,8228.9485,0.136
80,65,145,Tb,8178.5397,0.7648
79,66,145,Dy,8116.8884,0.045
78,67,145,Ho,8048.5792,0.0514
92,54,146,Xe,8110.4154,0.1659
91,55,146,Cs,8155.4365,0.0198
90,56,146,Ba,8215.5293,0.0121
89,57,146,La,8239.9988,0.0115
88,58,146,Ce,8278.5081,0.1004
87,59,146,Pr,8280.325,0.2353
86,60,146,Nd,8304.0927,0.0087
85,61,146,Pm,8288.655,0.0293
84,62,146,Sm,8293.8581,0.0209
83,63,146,Eu,8261.9327,0.0412
82,64,146,Gd,8249.5072,0.0279
81,65,146,Tb,8187.1474,0.3073
80,66,146,Dy,8146.1128,0.0459
79,67,146,Ho,8063.2426,0.0451
78,68,146,Er,8010.5127,0.0459
92,55,147,Cs,8131.801,0.057
91,56,147,Ba,8183.2405,0.1343
90,57,147,La,8221.5536,0.0729
89,58,147,Ce,8252.5274,0.0584
88,59,147,Pr,8270.54,0.1079
87,60,147,Nd,8283.6036,0.0087
86,61,147,Pm,8284.3712,0.0088
85,62,147,Sm,8280.5734,0.0086
84,63,147,Eu,8263.5409,0.0175
83,64,147,Gd,8243.3366,0.0128
82,65,147,Tb,8206.625,0.0551
81,66,147,Dy,8156.768,0.0602
80,67,147,Ho,8094.0381,0.034
79,68,147,Er,8026.476,0.2598
78,69,147,Tm,7948.8178,0.0465
93,55,148,Cs,8097.5469,0.0881
92,56,148,Ba,8164.1118,0.0101
91,57,148,La,8193.7165,0.1315
90,58,148,Ce,8240.3876,0.0756
89,59,148,Pr,8249.5409,0.1016
88,60,148,Nd,8277.1778,0.0139
87,61,148,Pm,8268.2283,0.0384
86,62,148,Sm,8279.6326,0.0084
85,63,148,Eu,8253.8155,0.0673
84,64,148,Gd,8248.3398,0.0099
83,65,148,Tb,8204.3207,0.0842
82,66,148,Dy,8180.943,0.0589
81,67,148,Ho,8108.9797,0.5664
80,68,148,Er,8059.6924,0.0692
79,69,148,Tm,7968.5011,0.0692
93,56,149,Ba,8131.8495,0.0169
92,57,149,La,8176.1915,1.344
91,58,149,Ce,8214.2294,0.0688
90,59,149,Pr,8238.304,0.0663
89,60,149,Nd,8255.4437,0.0138
88,61,149,Pm,8261.5277,0.0147
87,62,149,Sm,8263.4683,0.0078
86,63,149,Eu,8253.556,0.0262
85,64,149,Gd,8239.4856,0.0222
84,65,149,Tb,8209.8153,0.0244
83,66,149,Dy,8179.0972,0.0616
82,67,149,Ho,8133.255,0.0804
81,68,149,Er,8074.9558,0.1875
94,56,150,Ba,8111.8405,0.0379
93,57,150,La,8149.4339,0.0168
92,58,150,Ce,8201.123,0.078
91,59,150,Pr,8218.9316,0.0601
90,60,150,Nd,8249.5789,0.0075
89,61,150,Pm,8243.8125,0.1335
88,62,150,Sm,8261.6235,0.0074
87,63,150,Eu,8241.3481,0.0415
86,64,150,Gd,8242.6103,0.0404
85,65,150,Tb,8206.3396,0.0491
84,66,150,Dy,8189.1495,0.0288
83,67,150,Ho,8134.8423,0.0945
82,68,150,Er,8102.1962,0.1146
94,57,151,La,8129.0436,2.8839
93,58,151,Ce,8176.2779,0.1172
92,59,151,Pr,8207.8824,0.0772
91,60,151,Nd,8230.2741,0.0075
90,61,151,Pm,8241.2723,0.0305
89,62,151,Sm,8243.9735,0.0074
88,63,151,Eu,8239.2998,0.0077
87,64,151,Gd,8231.0446,0.0198
86,65,151,Tb,8208.8743,0.0271
85,66,151,Dy,8184.6789,0.0215
84,67,151,Ho,8145.5267,0.055
83,68,151,Er,8104.8723,0.1091
82,69,151,Tm,8050.0576,0.1283
81,70,151,Yb,7983.7556,1.99
93,59,152,Pr,8187.1049,0.122
92,60,152,Nd,8224.0078,0.161
91,61,152,Pm,8226.1293,0.1704
90,62,152,Sm,8244.0645,0.0067
89,63,152,Eu,8226.5854,0.0077
88,64,152,Gd,8233.4042,0.0066
87,65,152,Tb,8202.0072,0.2632
86,66,152,Dy,8192.9171,0.0302
85,67,152,Ho,8144.9193,0.0824
84,68,152,Er,8119.3485,0.0581
83,69,152,Tm,8056.4387,0.3554
82,70,152,Yb,8015.4371,0.9849
94,59,153,Pr,8172.0371,0.0777
93,60,153,Nd,8204.5832,0.018
92,61,153,Pm,8221.1536,0.0592
91,62,153,Sm,8228.5373,0.0067
90,63,153,Eu,8228.7011,0.0077
89,64,153,Gd,8220.4209,0.0066
88,65,153,Tb,8205.0504,0.0258
87,66,153,Dy,8185.7514,0.0262
86,67,153,Ho,8153.6372,0.0331
85,68,153,Er,8118.8154,0.0607
84,69,153,Tm,8071.2571,0.0783
82,71,153,Lu,7959.0882,0.9805
95,59,154,Pr,8147.2994,0.6494
94,60,154,Nd,8192.3491,0.0067
93,61,154,Pm,8204.717,0.1625
92,62,154,Sm,8226.8379,0.0085
91,63,154,Eu,8217.1006,0.0077
90,64,154,Gd,8224.7996,0.0065
89,65,154,Tb,8196.6697,0.2942
88,66,154,Dy,8193.1305,0.0483
87,67,154,Ho,8150.6825,0.0534
86,68,154,Er,8132.3919,0.0322
85,69,154,Tm,8074.209,0.0936
84,70,154,Yb,8039.9402,0.1122
96,59,155,Pr,8131.0398,0.111
95,60,155,Nd,8170.305,0.0591
94,61,155,Pm,8195.2977,0.0304
93,62,155,Sm,8211.2258,0.0086
92,63,155,Eu,8216.676,0.0081
91,64,155,Gd,8213.2541,0.0063
90,65,155,Tb,8202.9173,0.0634
89,66,155,Dy,8184.357,0.0622
88,67,155,Ho,8159.2055,0.1127
87,68,155,Er,8129.4444,0.0392
86,69,155,Tm,8088.376,0.064
85,70,155,Yb,8043.8234,0.1071
84,71,155,Lu,7987.4369,0.1242
97,59,156,Pr,8105.2337,0.0066
96,60,156,Nd,8156.3265,0.0084
95,61,156,Pm,8176.7263,0.0076
94,62,156,Sm,8205.0054,0.0546
93,63,156,Eu,8204.6192,0.0226
92,64,156,Gd,8215.3253,0.0063
91,65,156,Tb,8194.6415,0.0242
90,66,156,Dy,8192.4366,0.0063
89,67,156,Ho,8155.428,0.2463
88,68,156,Er,8141.9084,0.1579
87,69,156,Tm,8089.6032,0.0915
86,70,156,Yb,8061.7107,0.0597
85,71,156,Lu,7995.3752,0.3469
84,72,156,Hf,7952.6676,0.9599
98,59,157,Pr,8085.817,0.0202
97,60,157,Nd,8132.1671,0.0136
96,61,157,Pm,8164.1458,0.0446
95,62,157,Sm,8187.0642,0.0282
94,63,157,Eu,8199.7975,0.027
93,64,157,Gd,8203.5072,0.0062
92,65,157,Tb,8198.1416,0.0065
91,66,157,Dy,8184.6287,0.0328
90,67,157,Ho,8163.1373,0.1495
89,68,157,Er,8136.3757,0.1688
88,69,157,Tm,8101.4285,0.178
87,70,157,Yb,8062.7551,0.0695
86,71,157,Lu,8013.3128,0.0769
84,73,157,Ta,7896.0608,0.9557
98,60,158,Nd,8114.9529,0.0083
97,61,158,Pm,8143.3622,0.0056
96,62,158,Sm,8177.3075,0.0303
95,63,158,Eu,8185.132,0.0129
94,64,158,Gd,8201.8229,0.0062
93,65,158,Tb,8189.1556,0.008
92,66,158,Dy,8190.1298,0.0148
91,67,158,Ho,8158.4709,0.1716
90,68,158,Er,8147.927,0.1596
89,69,158,Tm,8101.1994,0.1596
88,70,158,Yb,8079.1999,0.0505
87,71,158,Lu,8018.5685,0.0957
86,72,158,Hf,7981.2764,0.1107
99,60,159,Nd,8088.8224,0.1875
98,61,159,Pm,8126.8601,0.0631
97,62,159,Sm,8157.4963,0.0373
96,63,159,Eu,8176.6987,0.0272
95,64,159,Gd,8187.6177,0.0062
94,65,159,Tb,8188.8025,0.0069
93,66,159,Dy,8181.5842,0.0091
92,67,159,Ho,8165.1066,0.0192
91,68,159,Er,8142.7742,0.0229
90,69,159,Tm,8112.7549,0.1758
89,70,159,Yb,8078.0428,0.1106
88,71,159,Lu,8034.6009,0.2369
87,72,159,Hf,7986.561,0.1057
86,73,159,Ta,7928.7258,0.1238
100,60,160,Nd,8069.9662,0.2911
99,61,160,Pm,8103.6398,0.0128
98,62,160,Sm,8144.6159,0.0122
97,63,160,Eu,8160.103,0.0057
96,64,160,Gd,8183.0171,0.007
95,65,160,Tb,8177.4676,0.0069
94,66,160,Dy,8184.0526,0.0044
93,67,160,Ho,8158.6004,0.0939
92,68,160,Er,8151.7217,0.1515
91,69,160,Tm,8110.8124,0.2043
90,70,160,Yb,8092.5614,0.0343
89,71,160,Lu,8038.3387,0.3551
88,72,160,Hf,8006.3791,0.0596
87,73,160,Ta,7938.2704,0.3395
86,74,160,W,7892.7893,0.9363
100,61,161,Pm,8085.9977,0.0561
99,62,161,Sm,8122.0418,0.0423
98,63,161,Eu,8148.981,0.0646
97,64,161,Gd,8167.1934,0.0093
96,65,161,Tb,8174.4809,0.0076
95,66,161,Dy,8173.3093,0.0043
94,67,161,Ho,8163.1134,0.0134
93,68,161,Er,8145.8628,0.0545
92,69,161,Tm,8120.4906,0.1736
91,70,161,Yb,8090.3861,0.0938
90,71,161,Lu,8052.7821,0.1736
89,72,161,Hf,8009.1245,0.1457
88,73,161,Ta,7957.45,0.1514
86,75,161,Re,7836.3292,0.9311
100,62,162,Sm,8107.5745,0.0218
99,63,162,Eu,8129.5593,0.0081
98,64,162,Gd,8159.0373,0.0245
97,65,162,Tb,8164.0773,0.0127
96,66,162,Dy,8173.4555,0.0043
95,67,162,Ho,8155.4126,0.0192
94,68,162,Er,8152.3959,0.0047
93,69,162,Tm,8117.5868,0.1609
92,70,162,Yb,8102.5333,0.0932
91,71,162,Lu,8054.5596,0.4632
90,72,162,Hf,8027.1171,0.0553
89,73,162,Ta,7964.3432,0.3909
88,74,162,W,7923.8214,0.109
101,62,163,Sm,8084.1653,0.0451
100,63,163,Eu,8116.0172,0.0056
99,64,163,Gd,8140.756,0.0049
98,65,163,Tb,8155.6322,0.0249
97,66,163,Dy,8161.784,0.0043
96,67,163,Ho,8156.967,0.0043
95,68,163,Er,8144.7403,0.0284
94,69,163,Tm,8124.9774,0.0338
93,70,163,Yb,8099.1069,0.0927
92,71,163,Lu,8066.6848,0.1714
91,72,163,Hf,8028.0072,0.1576
90,73,163,Ta,7981.8905,0.2335
89,74,163,W,7930.3043,0.3584
88,75,163,Re,7870.8655,0.1137
102,62,164,Sm,8067.7803,0.025
101,63,164,Eu,8095.3686,0.0126
100,64,164,Gd,8129.9978,0.0061
99,65,164,Tb,8139.9304,0.0114
98,66,164,Dy,8158.7129,0.0042
97,67,164,Ho,8147.9234,0.0085
96,68,164,Er,8149.0191,0.0043
95,69,164,Tm,8119.6534,0.1525
94,70,164,Yb,8109.4149,0.0921
93,71,164,Lu,8065.8043,0.1704
92,72,164,Hf,8043.8142,0.0964
91,73,164,Ta,7986.9978,0.1704
90,74,164,W,7951.4515,0.059
89,75,164,Re,7881.0523,0.3326
88,76,164,Os,7833.308,0.914
102,63,165,Eu,8080.0529,0.0316
101,64,165,Gd,8110.4428,0.0079
100,65,165,Tb,8130.3259,0.0093
99,66,165,Dy,8143.9083,0.0042
98,67,165,Ho,8146.9591,0.0048
97,68,165,Er,8139.9348,0.0056
96,69,165,Tm,8125.5489,0.0101
95,70,165,Yb,8104.8399,0.1608
94,71,165,Lu,8076.746,0.1608
93,72,165,Hf,8042.8728,0.1694
92,73,165,Ta,8003.0547,0.0823
91,74,165,W,7955.9704,0.1561
90,75,165,Re,7901.5201,0.143
102,64,166,Gd,8097.226,0.0095
101,65,166,Tb,8113.223,0.0088
100,66,166,Dy,8137.2793,0.0048
99,67,166,Ho,8135.4933,0.0047
98,68,166,Er,8141.9479,0.002
97,69,166,Tm,8118.9357,0.0696
96,70,166,Yb,8112.4591,0.0422
95,71,166,Lu,8074.1756,0.1796
94,72,166,Hf,8056.4386,0.1683
93,73,166,Ta,8004.9714,0.1683
92,74,166,W,7974.8951,0.057
91,75,166,Re,7909.6392,0.5316
90,76,166,Os,7866.3371,0.1082
103,64,167,Gd,8075.5428,0.0312
102,65,167,Tb,8101.441,0.0116
101,66,167,Dy,8120.8782,0.024
100,67,167,Ho,8130.3732,0.0311
99,68,167,Er,8131.7352,0.0017
98,69,167,Tm,8122.5826,0.0075
97,70,167,Yb,8106.202,0.0237
96,71,167,Lu,8083.1722,0.2231
95,72,167,Hf,8054.185,0.1673
94,73,167,Ta,8018.8614,0.1673
93,74,167,W,7976.7045,0.112
91,76,167,Os,7873.9557,0.4844
90,77,167,Ir,7812.8254,0.1099
103,65,168,Tb,8082.798,0.025
102,66,168,Dy,8112.5293,0.8334
101,67,168,Ho,8116.8061,0.1786
100,68,168,Er,8129.5897,0.0016
99,69,168,Tm,8114.9516,0.01
98,70,168,Yb,8111.887,0.0006
97,71,168,Lu,8080.4026,0.226
96,72,168,Hf,8065.5536,0.1663
95,73,168,Ta,8019.4287,0.1663
94,74,168,W,7993.9327,0.0789
93,75,168,Re,7935.1208,0.1835
92,76,168,Os,7895.9408,0.0589
91,77,168,Ir,7823.8509,0.3287
90,78,168,Pt,7773.6217,0.8925
103,66,169,Dy,8094.7566,1.7791
102,67,169,Ho,8109.0622,0.1186
101,68,169,Er,8117.0078,0.0018
100,69,169,Tm,8114.4702,0.0044
99,70,169,Yb,8104.5206,0.0011
98,71,169,Lu,8086.3233,0.0178
97,72,169,Hf,8061.7791,0.1654
96,73,169,Ta,8030.9577,0.1654
95,74,169,W,7994.5381,0.0913
94,75,169,Re,7951.3963,0.0673
93,76,169,Os,7901.2862,0.1535
92,77,169,Ir,7845.5944,0.1379
103,67,170,Ho,8093.7902,0.2942
102,68,170,Er,8111.9529,0.0082
101,69,170,Tm,8105.5144,0.0043
100,70,170,Yb,8106.6101,0.0003
99,71,170,Lu,8081.6686,0.0991
98,72,170,Hf,8070.8762,0.1644
97,73,170,Ta,8030.2965,0.1644
96,74,170,W,8008.9482,0.0776
95,75,170,Re,7955.012,0.0672
94,76,170,Os,7921.1258,0.0574
92,78,170,Pt,7808.2365,0.1073
104,67,171,Ho,8083.6021,3.5088
103,68,171,Er,8097.7404,0.0082
102,69,171,Tm,8101.8931,0.0057
101,70,171,Yb,8097.8826,0.0003
100,71,171,Lu,8084.6621,0.0109
99,72,171,Hf,8066.0687,0.1689
98,73,171,Ta,8039.7914,0.1634
97,74,171,W,8008.1158,0.1634
96,75,171,Re,7969.4131,0.1634
95,76,171,Os,7924.1769,0.1067
94,77,171,Ir,7873.4895,0.2249
93,78,171,Pt,7816.6017,0.4734
92,79,171,Au,7754.1069,0.1211
104,68,172,Er,8090.4052,0.023
103,69,172,Tm,8091.0367,0.0319
102,70,172,Yb,8097.4295,0.0003
101,71,172,Lu,8078.2334,0.0136
100,72,172,Hf,8071.7439,0.142
99,73,172,Ta,8037.7056,0.1625
98,74,172,W,8020.1757,0.1625
97,75,172,Re,7971.846,0.2068
96,76,172,Os,7942.1626,0.0742
95,77,172,Ir,7880.2637,0.1884
94,78,172,Pt,7839.246,0.0603
93,79,172,Au,7766.1587,0.3265
92,80,172,Hg,7713.6064,0.8725
104,69,173,Tm,8084.4633,0.0254
103,70,173,Yb,8087.4276,0.0003
102,71,173,Lu,8079.0312,0.0091
101,72,173,Hf,8066.0164,0.1615
100,73,173,Ta,8044.065,0.1615
99,74,173,W,8018.3337,0.1615
98,75,173,Re,7983.9068,0.1615
97,76,173,Os,7944.0341,0.0865
96,77,173,Ir,7898.068,0.0609
95,78,173,Pt,7845.3856,0.3667
94,79,173,Au,7788.2348,0.1317
105,69,174,Tm,8070.6432,0.257
104,70,174,Yb,8083.8481,0.0003
103,71,174,Lu,8071.454,0.009
102,72,174,Hf,8068.5341,0.013
101,73,174,Ta,8040.4528,0.1606
100,74,174,W,8027.2572,0.1606
99,75,174,Re,7985.0944,0.1606
98,76,174,Os,7959.4618,0.0589
97,77,174,Ir,7902.0377,0.0645
96,78,174,Pt,7866.1143,0.0594
94,80,174,Hg,7749.7851,0.1104
106,69,175,Tm,8061.7673,0.2857
105,70,175,Yb,8070.9253,0.0005
104,71,175,Lu,8069.1412,0.0069
103,72,175,Hf,8060.7625,0.013
102,73,175,Ta,8044.4456,0.1597
101,74,175,W,8024.113,0.1597
100,75,175,Re,7994.8168,0.1597
99,76,175,Os,7960.7294,0.0673
98,77,175,Ir,7917.9112,0.0708
97,78,175,Pt,7869.5216,0.1064
96,79,175,Au,7817.5939,0.2204
95,80,175,Hg,7759.2134,0.4633
107,69,176,Tm,8045.1214,0.5682
106,70,176,Yb,8064.0853,0.0003
105,71,176,Lu,8059.0209,0.0069
104,72,176,Hf,8061.3604,0.0084
103,73,176,Ta,8038.6706,0.1747
102,74,176,W,8030.1131,0.1588
101,75,176,Re,7993.9707,0.1588
100,76,176,Os,7972.8681,0.0622
99,77,176,Ir,7921.5522,0.0459
98,78,176,Pt,7888.9934,0.0722
97,79,176,Au,7825.3837,0.1885
96,80,176,Hg,7782.664,0.0632
95,81,176,Tl,7707.9383,0.4719
107,70,177,Yb,8049.9741,0.0013
106,71,177,Lu,8053.4495,0.0069
105,72,177,Hf,8051.8365,0.008
104,73,177,Ta,8040.8289,0.0187
103,74,177,W,8025.0359,0.1579
102,75,177,Re,8001.2229,0.1579
101,76,177,Os,7972.4371,0.0826
100,77,177,Ir,7934.6328,0.1116
99,78,177,Pt,7892.4896,0.0847
98,79,177,Au,7843.8623,0.0563
97,80,177,Hg,7789.8947,0.4787
96,81,177,Tl,7732.1655,0.1222
108,70,178,Yb,8042.7386,0.037
107,71,178,Lu,8042.0554,0.0127
106,72,178,Hf,8049.4438,0.008
104,74,178,W,8029.2584,0.0854
103,75,178,Re,7998.1576,0.157
102,76,178,Os,7981.9128,0.0766
101,77,178,Ir,7936.563,0.1057
100,78,178,Pt,7908.253,0.0569
99,79,178,Au,7849.3946,0.0576
98,80,178,Hg,7811.3607,0.0604
96,82,178,Pb,7690.8359,0.1302
108,71,179,Lu,8035.0744,0.0288
107,72,179,Hf,8038.5474,0.0079
106,73,179,Ta,8033.5869,0.0082
105,74,179,W,8023.2821,0.0814
104,75,179,Re,8003.7666,0.1376
103,76,179,Os,7979.4844,0.0866
102,77,179,Ir,7947.5248,0.0546
101,78,179,Pt,7910.6759,0.0446
100,79,179,Au,7865.6374,0.0653
99,80,179,Hg,7816.2631,0.1571
98,81,179,Tl,7763.4942,0.2159
97,82,179,Pb,7701.463,0.4538
109,71,180,Lu,8022.0394,0.3929
108,72,180,Hf,8034.9319,0.0079
107,73,180,Ta,8025.8864,0.0115
106,74,180,W,8025.4434,0.008
105,75,180,Re,7999.9922,0.1188
104,76,180,Os,7987.4171,0.0873
103,77,180,Ir,7947.6337,0.1206
102,78,180,Pt,7923.5781,0.0558
101,79,180,Au,7870.3194,0.0264
100,80,180,Hg,7836.1111,0.0702
99,81,180,Tl,7771.431,0.3884
98,82,180,Pb,7725.6993,0.0689
110,71,181,Lu,8011.9301,0.6948
109,72,181,Hf,8022.003,0.0079
108,73,181,Ta,8023.405,0.0087
107,74,181,W,8017.9494,0.008
106,75,181,Re,8004.1434,0.0693
105,76,181,Os,7983.4263,0.14
104,77,181,Ir,7956.5242,0.029
103,78,181,Pt,7924.1271,0.0756
102,79,181,Au,7883.8359,0.1104
101,80,181,Hg,7839.6792,0.085
100,81,181,Tl,7791.9183,0.0503
99,82,181,Pb,7734.0704,0.4698
110,72,182,Hf,8014.8381,0.0339
109,73,182,Ta,8012.6332,0.0087
108,74,182,W,8018.3096,0.0041
107,75,182,Re,7998.6264,0.5603
106,76,182,Os,7989.7287,0.1195
105,77,182,Ir,7954.8948,0.1152
104,78,182,Pt,7934.7541,0.0719
103,79,182,Au,7887.2442,0.1031
102,80,182,Hg,7856.9726,0.0538
101,81,182,Tl,7796.3571,0.0658
100,82,182,Pb,7756.3296,0.0664
112,71,183,Lu,7984.8125,0.4378
111,72,183,Hf,8000.0315,0.1642
110,73,183,Ta,8006.74,0.0087
109,74,183,W,8008.3234,0.0041
108,75,183,Re,8001.0101,0.0439
107,76,183,Os,7985.0087,0.272
106,77,183,Ir,7961.8176,0.1348
105,78,183,Pt,7933.3406,0.0777
104,79,183,Au,7898.5644,0.0515
103,80,183,Hg,7859.3885,0.0387
102,81,183,Tl,7815.6741,0.051
101,82,183,Pb,7762.179,0.1584
112,72,184,Hf,7990.7228,0.2158
111,73,184,Ta,7993.7535,0.1414
110,74,184,W,8005.0777,0.004
109,75,184,Re,7992.7517,0.0232
108,76,184,Os,7988.6778,0.0045
107,77,184,Ir,7959.1992,0.1519
106,78,184,Pt,7942.5649,0.0801
105,79,184,Au,7900.1947,0.1211
104,80,184,Hg,7874.3454,0.0518
103,81,184,Tl,7818.6727,0.0544
102,82,184,Pb,7782.7264,0.0696
113,72,185,Hf,7973.9711,0.3474
112,73,185,Ta,7986.3615,0.0765
111,74,185,W,7992.9083,0.004
110,75,185,Re,7991.0101,0.0044
109,76,185,Os,7981.3047,0.0045
108,77,185,Ir,7963.7226,0.1511
107,78,185,Pt,7939.7779,0.1396
106,79,185,Au,7909.441,0.0141
105,80,185,Hg,7874.5391,0.0737
104,81,185,Tl,7835.5756,0.1118
103,82,185,Pb,7786.933,0.0874
114,72,186,Hf,7964.3032,0.2754
113,73,186,Ta,7971.8357,0.3226
112,74,186,W,7988.6026,0.0065
111,75,186,Re,7981.2713,0.0044
110,76,186,Os,7982.8324,0.0041
109,77,186,Ir,7958.0473,0.0888
108,78,186,Pt,7946.8094,0.1169
107,79,186,Au,7909.5409,0.1127
106,80,186,Hg,7888.2605,0.0626
105,81,186,Tl,7837.5161,0.1116
104,82,186,Pb,7805.342,0.0592
103,83,186,Bi,7739.1175,0.0911
102,84,186,Po,7695.9488,0.0983
114,73,187,Ta,7963.2123,0.2989
113,74,187,W,7975.1168,0.0065
112,75,187,Re,7977.9519,0.0039
111,76,187,Os,7973.7814,0.0039
110,77,187,Ir,7960.6692,0.1494
109,78,187,Pt,7941.1699,0.1287
108,79,187,Au,7917.4323,0.1203
107,80,187,Hg,7886.9905,0.0688
106,81,187,Tl,7852.465,0.043
105,82,187,Pb,7808.401,0.0272
104,83,187,Bi,7758.2083,0.0535
103,84,187,Po,7704.7889,0.1745
114,74,188,W,7969.0532,0.0164
113,75,188,Re,7966.7481,0.0039
112,76,188,Os,7973.8656,0.0039
111,77,188,Ir,7954.8512,0.0501
110,78,188,Pt,7947.9027,0.0282
109,79,188,Au,7914.7537,0.0144
108,80,188,Hg,7899.034,0.0361
107,81,188,Tl,7853.0537,0.1591
106,82,188,Pb,7824.8211,0.0539
105,83,188,Bi,7764.1904,0.0595
104,84,188,Po,7724.6544,0.1062
114,75,189,Re,7961.8105,0.0433
113,76,189,Os,7963.0029,0.0035
112,77,189,Ir,7956.0214,0.0665
111,78,189,Pt,7941.4045,0.0534
110,79,189,Au,7921.9876,0.1063
109,80,189,Hg,7896.9192,0.1669
108,81,189,Tl,7866.2704,0.0443
107,82,189,Pb,7826.2999,0.0744
106,83,189,Bi,7780.9999,0.1103
105,84,189,Po,7731.1321,0.1167
116,74,190,W,7947.5031,0.1863
115,75,190,Re,7949.7759,0.0256
114,76,190,Os,7962.1047,0.0034
113,77,190,Ir,7947.7017,0.0072
112,78,190,Pt,7946.4941,0.0035
111,79,190,Au,7918.8345,0.0181
110,80,190,Hg,7907.0174,0.0837
109,81,190,Tl,7866.0345,0.0382
108,82,190,Pb,7841.1294,0.0659
107,83,190,Bi,7785.3239,0.1104
106,84,190,Po,7749.4526,0.0693
117,74,191,W,7931.4359,0.2195
116,75,191,Re,7943.9588,0.0537
115,76,191,Os,7950.5687,0.0035
114,77,191,Ir,7948.1144,0.0069
113,78,191,Pt,7938.7279,0.0216
112,79,191,Au,7924.6819,0.0258
111,80,191,Hg,7903.8002,0.1167
110,81,191,Tl,7877.1445,0.0385
109,82,191,Pb,7841.6782,0.0346
108,83,191,Bi,7800.6613,0.0392
107,84,191,Po,7753.7871,0.0372
106,85,191,At,7702.9233,0.0843
117,75,192,Re,7930.2389,0.3687
116,76,192,Os,7948.526,0.0121
115,77,192,Ir,7938.9999,0.0068
114,78,192,Pt,7942.4923,0.0134
113,79,192,Au,7920.1033,0.0824
112,80,192,Hg,7912.0666,0.0809
111,81,192,Tl,7876.0167,0.165
110,82,192,Pb,7854.6482,0.0298
109,83,192,Bi,7803.6084,0.1568
108,84,192,Po,7771.0542,0.0554
107,85,192,At,7709.7283,0.1452
118,75,193,Re,7923.9378,0.2027
117,76,193,Os,7936.2716,0.012
116,77,193,Ir,7938.1346,0.0069
115,78,193,Pt,7933.7875,0.007
114,79,193,Au,7924.1648,0.0449
113,80,193,Hg,7907.973,0.0803
112,81,193,Tl,7885.3445,0.0348
111,82,193,Pb,7854.0994,0.0533
110,83,193,Bi,7817.1718,0.0393
109,84,193,Po,7773.951,0.0753
108,85,193,At,7727.1099,0.1121
107,86,193,Rn,7675.853,0.1301
118,76,194,Os,7932.0232,0.0124
117,77,194,Ir,7928.4885,0.0069
116,78,194,Pt,7935.942,0.0026
115,79,194,Au,7918.7744,0.0109
114,80,194,Hg,7914.5974,0.0149
113,81,194,Tl,7883.5211,0.072
112,82,194,Pb,7865.4181,0.0899
111,83,194,Bi,7819.1955,0.0271
110,84,194,Po,7789.2947,0.0666
109,85,194,At,7732.2304,0.1211
108,86,194,Rn,7694.9961,0.0859
119,76,195,Os,7917.7449,0.2866
118,77,195,Ir,7924.916,0.0068
117,78,195,Pt,7926.553,0.0026
116,79,195,Au,7921.3778,0.0057
115,80,195,Hg,7909.398,0.1187
114,81,195,Tl,7890.7293,0.0571
113,82,195,Pb,7864.0647,0.0261
112,83,195,Bi,7830.7579,0.0271
111,84,195,Po,7791.3155,0.031
110,85,195,At,7748.0914,0.0491
109,86,195,Rn,7700.3841,0.2651
120,76,196,Os,7912.2301,0.2044
119,77,196,Ir,7914.1487,0.196
118,78,196,Pt,7926.5297,0.0026
117,79,196,Au,7914.8553,0.0151
116,80,196,Hg,7914.37,0.015
115,81,196,Tl,7888.29,0.0618
114,82,196,Pb,7873.3374,0.0393
113,83,196,Bi,7831.9009,0.1246
112,84,196,Po,7804.7445,0.0275
111,85,196,At,7752.0001,0.1543
110,86,196,Rn,7717.966,0.0717
120,77,197,Ir,7909.0003,0.1021
119,78,197,Pt,7915.9714,0.0027
118,79,197,Au,7915.6548,0.0028
117,80,197,Hg,7908.6402,0.0163
116,81,197,Tl,7893.5725,0.0689
115,82,197,Pb,7871.2822,0.0244
114,83,197,Bi,7841.6348,0.0423
113,84,197,Po,7805.7136,0.0501
112,85,197,At,7766.0174,0.0405
111,86,197,Rn,7722.119,0.0822
110,87,197,Fr,7673.764,0.2865
120,78,198,Pt,7914.1512,0.0106
119,79,198,Au,7908.5675,0.0027
118,80,198,Hg,7911.5532,0.0023
117,81,198,Tl,7890.3011,0.0381
116,82,198,Pb,7878.9695,0.0442
115,83,198,Bi,7841.2123,0.1392
114,84,198,Po,7817.5611,0.088
113,85,198,At,7769.3446,0.0248
112,86,198,Rn,7737.7245,0.0678
111,87,198,Fr,7679.1873,0.1572
122,77,199,Ir,7891.2066,0.2063
121,78,199,Pt,7902.3011,0.0109
120,79,199,Au,7906.9379,0.0027
119,80,199,Hg,7905.2794,0.0027
118,81,199,Tl,7893.8773,0.1404
117,82,199,Pb,7875.7366,0.0343
116,83,199,Bi,7849.5232,0.0533
115,84,199,Po,7817.6582,0.0273
114,85,199,At,7781.4883,0.0271
113,86,199,Rn,7741.0568,0.0367
112,87,199,Fr,7695.2599,0.069
122,78,200,Pt,7899.1986,0.1006
121,79,200,Au,7898.4915,0.1336
120,80,200,Hg,7905.8956,0.0027
119,81,200,Tl,7889.7037,0.0288
118,82,200,Pb,7881.8101,0.05
117,83,200,Bi,7848.4969,0.1135
116,84,200,Po,7827.4407,0.0379
115,85,200,At,7783.7601,0.1223
114,86,200,Rn,7754.9111,0.029
113,87,200,Fr,7700.3292,0.1526
123,78,201,Pt,7885.8337,0.2493
122,79,201,Au,7895.1752,0.016
121,80,201,Hg,7897.5607,0.0036
120,81,201,Tl,7891.2717,0.0706
119,82,201,Pb,7877.8782,0.0684
118,83,201,Bi,7854.8713,0.0606
117,84,201,Po,7826.5619,0.0246
116,85,201,At,7794.1536,0.0407
115,86,201,Rn,7757.0174,0.0504
114,87,201,Fr,7714.8367,0.0452
113,88,201,Ra,7669.4108,0.101
124,78,202,Pt,7881.5609,0.1245
123,79,202,Au,7885.91,0.1153
122,80,202,Hg,7896.8505,0.0035
121,81,202,Tl,7886.2206,0.0091
120,82,202,Pb,7882.1505,0.0188
119,83,202,Bi,7852.5857,0.0693
118,84,202,Po,7834.8053,0.0429
117,85,202,At,7794.5637,0.1366
116,86,202,Rn,7769.3018,0.0867
115,87,202,Fr,7719.0125,0.0299
114,88,202,Ra,7685.5684,0.0743
124,79,203,Au,7880.865,0.0152
123,80,203,Hg,7887.4828,0.008
122,81,203,Tl,7886.053,0.0058
121,82,203,Pb,7877.397,0.0323
120,83,203,Bi,7857.4762,0.0629
119,84,203,Po,7832.8632,0.0229
118,85,203,At,7803.6487,0.0523
117,86,203,Rn,7770.3437,0.0286
116,87,203,Fr,7731.7092,0.0307
115,88,203,Ra,7689.8015,0.0477
124,80,204,Hg,7885.5455,0.0025
123,81,204,Tl,7880.0238,0.0057
122,82,204,Pb,7879.9326,0.0056
121,83,204,Bi,7854.2157,0.045
120,84,204,Po,7839.0823,0.0494
119,85,204,At,7803.5522,0.1111
118,86,204,Rn,7780.5743,0.0365
117,87,204,Fr,7734.6931,0.1205
116,88,204,Ra,7704.1238,0.0437
125,80,205,Hg,7874.7325,0.0178
124,81,205,Tl,7878.3946,0.006
123,82,205,Pb,7874.3313,0.0056
122,83,205,Bi,7857.3218,0.0235
121,84,205,Po,7836.2168,0.0491
120,85,205,At,7810.2694,0.0588
119,86,205,Rn,7780.7226,0.0248
118,87,205,Fr,7745.687,0.0382
117,88,205,Ra,7707.1698,0.1111
116,89,205,Ac,7662.8519,0.2894
126,80,206,Hg,7869.1723,0.0992
125,81,206,Tl,7871.7219,0.0062
124,82,206,Pb,7875.362,0.0056
123,83,206,Bi,7853.3249,0.0371
122,84,206,Po,7840.5973,0.0195
121,85,206,At,7808.8904,0.0657
120,86,206,Rn,7789.0417,0.0417
119,87,206,Fr,7746.9621,0.135
118,88,206,Ra,7719.8028,0.0874
117,89,206,Ac,7667.8538,0.316
127,80,207,Hg,7848.6112,0.144
126,81,207,Tl,7866.7979,0.0263
125,82,207,Pb,7869.8664,0.0055
124,83,207,Bi,7854.5053,0.0116
123,84,207,Po,7836.6734,0.0322
122,85,207,At,7813.9653,0.0599
121,86,207,Rn,7787.9987,0.0229
120,87,207,Fr,7756.2689,0.0848
119,88,207,Ra,7721.7503,0.2816
118,89,207,Ac,7681.1001,0.2717
128,80,208,Hg,7834.1914,0.1478
127,81,208,Tl,7847.1835,0.0089
126,82,208,Pb,7867.453,0.0055
125,83,208,Bi,7849.8534,0.0111
124,84,208,Po,7839.3568,0.008
123,85,208,At,7811.5604,0.0429
122,86,208,Rn,7794.2678,0.0489
121,87,208,Fr,7756.8985,0.056
120,88,208,Ra,7732.0177,0.0434
119,89,208,Ac,7684.8289,0.31
118,90,208,Th,7652.5716,0.1532
128,81,209,Tl,7833.3979,0.0292
127,82,209,Pb,7848.6488,0.0084
126,83,209,Bi,7847.9869,0.0065
125,84,209,Po,7835.1882,0.0085
124,85,209,At,7814.7835,0.0227
123,86,209,Rn,7792.1755,0.0477
122,87,209,Fr,7763.7485,0.055
121,88,209,Ra,7733.0177,0.0275
120,89,209,Ac,7695.8455,0.2672
129,81,210,Tl,7813.589,0.0553
128,82,210,Pb,7835.9656,0.0069
127,83,210,Bi,7832.5424,0.0065
126,84,210,Po,7834.3462,0.0055
125,85,210,At,7811.6638,0.0366
124,86,210,Rn,7796.6653,0.0217
123,87,210,Fr,7763.1243,0.0639
122,88,210,Ra,7741.3687,0.0438
121,89,210,Ac,7698.0182,0.2962
120,90,210,Th,7669.0764,0.09
130,81,211,Tl,7799.7915,0.1987
129,82,211,Pb,7817.0079,0.0107
128,83,211,Bi,7819.7745,0.0258
127,84,211,Po,7818.7842,0.006
126,85,211,At,7811.3545,0.0129
125,86,211,Rn,7793.9412,0.0323
124,87,211,Fr,7768.3613,0.0568
123,88,211,Ra,7741.0887,0.0235
122,89,211,Ac,7707.468,0.2548
121,90,211,Th,7671.8506,0.4079
120,91,211,Pa,7629.3948,0.3293
130,82,212,Pb,7804.3203,0.0087
129,83,212,Bi,7803.314,0.0087
128,84,212,Po,7810.2438,0.0054
127,85,212,At,7798.34,0.0113
126,86,212,Rn,7794.7963,0.0147
125,87,212,Fr,7766.8455,0.0414
124,88,212,Ra,7747.5078,0.0484
123,89,212,Ac,7708.4479,0.1032
122,90,212,Th,7682.0628,0.0477
121,91,212,Pa,7633.6289,0.4132
132,81,213,Tl,7765.4311,0.1268
131,82,213,Pb,7785.1732,0.0326
130,83,213,Bi,7791.0217,0.0239
129,84,213,Po,7794.024,0.0143
128,85,213,At,7790.0036,0.023
127,86,213,Rn,7782.1824,0.0158
126,87,213,Fr,7768.4543,0.0221
125,88,213,Ra,7746.4726,0.0461
124,89,213,Ac,7715.5908,0.0548
123,90,213,Th,7683.847,0.0433
122,91,213,Pa,7644.8027,0.2684
132,82,214,Pb,7772.3955,0.0092
131,83,214,Bi,7773.4955,0.0524
130,84,214,Po,7785.1163,0.0068
129,85,214,At,7776.3632,0.0186
128,86,214,Rn,7777.1023,0.0429
127,87,214,Fr,7757.7393,0.0398
126,88,214,Ra,7749.1719,0.0245
125,89,214,Ac,7715.8874,0.0633
124,90,214,Th,7692.3173,0.0498
123,91,214,Pa,7647.7037,0.3795
133,82,215,Pb,7752.7381,0.245
132,83,215,Bi,7761.7177,0.0262
131,84,215,Po,7768.1768,0.0099
130,85,215,At,7767.8627,0.0308
129,86,215,Rn,7763.8164,0.0283
128,87,215,Fr,7753.2607,0.0329
127,88,215,Ra,7739.3249,0.0335
126,89,215,Ac,7719.4137,0.0577
125,90,215,Th,7693.0266,0.0295
124,91,215,Pa,7657.3733,0.3835
123,92,215,U,7620.7821,0.4844
133,83,216,Bi,7743.4996,0.0518
132,84,216,Po,7758.8205,0.0084
131,85,216,At,7753.0024,0.0166
130,86,216,Rn,7758.6553,0.0267
129,87,216,Fr,7742.4513,0.0193
128,88,216,Ra,7737.3458,0.0371
127,89,216,Ac,7711.2319,0.0427
126,90,216,Th,7697.6617,0.0514
125,91,216,Pa,7659.2006,0.1141
124,92,216,U,7631.3072,0.1301
134,83,217,Bi,7731.8491,0.0816
133,84,217,Po,7741.3614,0.0302
132,85,217,At,7744.6172,0.023
131,86,217,Rn,7744.4037,0.0193
130,87,217,Fr,7737.775,0.0301
129,88,217,Ra,7726.9122,0.0325
128,89,217,Ac,7710.3448,0.0517
127,90,217,Th,7690.5945,0.0489
126,91,217,Pa,7664.6438,0.0576
135,83,218,Bi,7712.828,0.1239
134,84,218,Po,7731.53,0.009
133,85,218,At,7729.1175,0.0528
132,86,218,Rn,7738.7527,0.0106
131,87,218,Fr,7726.7143,0.0194
130,88,218,Ra,7725.0241,0.045
129,89,218,Ac,7702.145,0.2643
128,90,218,Th,7691.6026,0.0482
127,91,218,Pa,7659.1935,0.0819
126,92,218,U,7640.7191,0.0629
135,84,219,Po,7713.334,0.0723
134,85,219,At,7720.197,0.0148
133,86,219,Rn,7723.7784,0.0096
132,87,219,Fr,7721.1759,0.0314
131,88,219,Ra,7714.056,0.0311
130,89,219,Ac,7700.5489,0.2351
129,90,219,Th,7683.7655,0.2578
128,91,219,Pa,7661.3783,0.3183
127,92,219,U,7636.2867,0.0609
126,93,219,Np,7604.6732,0.4199
136,84,220,Po,7703.2244,0.0804
135,85,220,At,7703.7033,0.0635
134,86,220,Rn,7717.2552,0.0082
133,87,220,Fr,7709.743,0.0183
132,88,220,Ra,7711.6879,0.0345
131,89,220,Ac,7692.3515,0.0279
130,90,220,Th,7684.4964,0.0622
129,91,220,Pa,7655.5364,0.0666
127,93,220,Np,7602.0758,0.1396
137,84,221,Po,7684.4814,0.0885
136,85,221,At,7694.4754,0.0632
135,86,221,Rn,7701.3941,0.0259
134,87,221,Fr,7703.2572,0.0221
133,88,221,Ra,7701.1352,0.021
132,89,221,Ac,7690.5039,0.2575
131,90,221,Th,7676.064,0.0362
130,91,221,Pa,7656.9809,0.2687
129,92,221,U,7634.6849,0.3264
138,84,222,Po,7674.0054,0.1804
137,85,222,At,7677.3878,0.0713
136,86,222,Rn,7694.4991,0.0088
135,87,222,Fr,7690.9474,0.0336
134,88,222,Ra,7696.6931,0.0201
133,89,222,Ac,7682.8015,0.0212
132,90,222,Th,7676.6592,0.046
131,91,222,Pa,7651.2373,0.3901
130,92,222,U,7637.7651,0.2342
129,93,222,Np,7602.7013,0.1714
138,85,223,At,7668.0557,0.0627
137,86,223,Rn,7678.172,0.0351
136,87,223,Fr,7683.6655,0.0087
135,88,223,Ra,7685.3101,0.0094
134,89,223,Ac,7679.1479,0.0312
133,90,223,Th,7668.6426,0.0356
132,91,223,Pa,7651.8957,0.3392
131,92,223,U,7631.7611,0.2648
130,93,223,Np,7607.5654,0.3716
139,85,224,At,7650.7354,0.0998
138,86,224,Rn,7670.7514,0.0438
137,87,224,Fr,7670.368,0.0499
136,88,224,Ra,7679.9236,0.0081
135,89,224,Ac,7670.1438,0.0183
134,90,224,Th,7667.7162,0.0429
133,91,224,Pa,7646.9612,0.0339
132,92,224,U,7635.0742,0.0681
131,93,224,Np,7603.5032,0.1291
139,86,225,Rn,7654.3581,0.0495
138,87,225,Fr,7662.9412,0.0532
137,88,225,Ra,7667.5866,0.0115
136,89,225,Ac,7665.6906,0.0211
135,90,225,Th,7659.2229,0.0226
134,91,225,Pa,7646.6504,0.3639
133,92,225,U,7629.7717,0.0442
132,93,225,Np,7607.4231,0.4072
140,86,226,Rn,7646.4108,0.0464
139,87,226,Fr,7648.3768,0.0276
138,88,226,Ra,7661.9636,0.0085
137,89,226,Ac,7655.6628,0.0137
136,90,226,Th,7657.1195,0.0198
135,91,226,Pa,7641.1093,0.0496
134,92,226,U,7631.9166,0.049
133,93,226,Np,7604.1714,0.4516
141,86,227,Rn,7630.0508,0.0621
140,87,227,Fr,7640.7162,0.026
139,88,227,Ra,7648.3048,0.0086
138,89,227,Ac,7650.7084,0.0085
137,90,227,Th,7647.4591,0.0092
136,91,227,Pa,7639.4945,0.032
135,92,227,U,7626.2918,0.0375
134,93,227,Np,7607.2771,0.3392
142,86,228,Rn,7621.6457,0.0775
141,87,228,Fr,7626.3689,0.0295
140,88,228,Ra,7642.4289,0.0088
139,89,228,Ac,7639.1973,0.0092
138,90,228,Th,7645.0807,0.0079
137,91,228,Pa,7632.2076,0.019
136,92,228,U,7627.4763,0.0591
134,94,228,Pu,7590.4039,0.1024
143,86,229,Rn,7605.6227,0.0569
142,87,229,Fr,7618.338,0.0218
141,88,229,Ra,7628.4862,0.0674
140,89,229,Ac,7633.2446,0.0529
139,90,229,Th,7634.651,0.0105
138,91,229,Pa,7629.8752,0.0143
137,92,229,U,7620.7218,0.0259
136,93,229,Np,7605.9921,0.4418
135,94,229,Pu,7586.8834,0.2648
134,95,229,Am,7562.5697,0.4644
143,87,230,Fr,7603.7052,0.0284
142,88,230,Ra,7621.9144,0.0448
141,89,230,Ac,7621.4604,0.0689
140,90,230,Th,7630.9974,0.0053
139,91,230,Pa,7621.8958,0.0132
138,92,230,U,7620.9227,0.0196
137,93,230,Np,7601.7751,0.2392
136,94,230,Pu,7591.0016,0.0628
144,87,231,Fr,7594.5009,0.0335
143,88,231,Ra,7607.8418,0.0492
142,89,231,Ac,7615.0768,0.0565
141,90,231,Th,7620.1188,0.0053
140,91,231,Pa,7618.4267,0.0077
139,92,231,U,7613.3879,0.0116
138,93,231,Np,7602.1321,0.2214
137,94,231,Pu,7587.1224,0.0955
145,87,232,Fr,7579.3481,0.0602
144,88,232,Ra,7600.0099,0.0394
143,89,232,Ac,7602.4245,0.0562
142,90,232,Th,7615.0338,0.0061
141,91,232,Pa,7609.5072,0.033
140,92,232,U,7611.8984,0.0078
138,94,232,Pu,7588.9839,0.0728
146,87,233,Fr,7569.2398,0.084
145,88,233,Ra,7585.5644,0.0369
144,89,233,Ac,7595.1939,0.056
143,90,233,Th,7602.8937,0.0061
142,91,233,Pa,7604.8675,0.0057
141,92,233,U,7603.9574,0.0097
140,93,233,Np,7596.1816,0.2188
139,94,233,Pu,7583.7968,0.2325
137,96,233,Cm,7546.002,0.348
146,88,234,Ra,7576.5439,0.0358
145,89,234,Ac,7582.1297,0.0597
144,90,234,Th,7596.8557,0.0111
143,91,234,Pa,7594.6837,0.0175
142,92,234,U,7600.716,0.0048
141,93,234,Np,7589.6382,0.0359
140,94,234,Pu,7584.6061,0.0291
138,96,234,Cm,7550.6868,0.073
146,89,235,Ac,7573.5051,0.0595
145,90,235,Th,7584.3862,0.0555
144,91,235,Pa,7588.4139,0.0595
143,92,235,U,7590.9151,0.0048
142,93,235,Np,7587.0571,0.0059
141,94,235,Pu,7578.8799,0.0873
140,95,235,Am,7565.1582,0.2246
147,89,236,Ac,7559.2423,0.1618
146,90,236,Th,7576.9688,0.0592
145,91,236,Pa,7577.5573,0.0592
144,92,236,U,7586.4854,0.0047
143,93,236,Np,7579.2148,0.2136
142,94,236,Pu,7577.9192,0.0077
140,96,236,Cm,7550.309,0.0747
147,90,237,Th,7563.4433,0.0668
146,91,237,Pa,7570.3847,0.055
145,92,237,U,7576.1026,0.0051
144,93,237,Np,7574.9895,0.0047
143,94,237,Pu,7570.7599,0.0072
141,96,237,Cm,7546.6241,0.3139
139,98,237,Cf,7503.3507,0.4107
147,91,238,Pa,7558.3449,0.0665
146,92,238,U,7570.1262,0.0063
145,93,238,Np,7566.222,0.0048
144,94,238,Pu,7568.3611,0.0048
143,95,238,Am,7555.5853,0.2475
142,96,238,Cm,7547.9966,0.0514
147,92,239,U,7558.5624,0.0063
146,93,239,Np,7560.568,0.0055
145,94,239,Pu,7560.3187,0.0047
144,95,239,Am,7553.6891,0.0083
143,96,239,Cm,7543.0659,0.6279
148,92,240,U,7551.7705,0.0106
147,93,240,Np,7550.1743,0.071
146,94,240,Pu,7556.0433,0.0046
145,95,240,Am,7547.0136,0.0576
144,96,240,Cm,7542.8617,0.0079
142,98,240,Cf,7510.24,0.0751
148,93,241,Np,7544.0426,0.415
147,94,241,Pu,7546.4395,0.0046
146,95,241,Am,7543.2795,0.0046
145,96,241,Cm,7536.8488,0.0067
149,93,242,Np,7533.4042,0.8265
148,94,242,Pu,7541.3284,0.0052
147,95,242,Am,7534.9917,0.0046
146,96,242,Cm,7534.504,0.0047
144,98,242,Cf,7509.0991,0.0533
149,94,243,Pu,7531.0087,0.0105
148,95,243,Am,7530.1742,0.0057
147,96,243,Cm,7526.9261,0.0062
146,97,243,Bk,7517.5021,0.0186
150,94,244,Pu,7524.8154,0.0096
149,95,244,Am,7521.3095,0.0061
148,96,244,Cm,7523.9527,0.0045
147,97,244,Bk,7511.4759,0.059
146,98,244,Cf,7505.1373,0.0107
151,94,245,Pu,7513.2822,0.0556
150,95,245,Am,7515.3043,0.0077
149,96,245,Cm,7515.7677,0.0047
148,97,245,Bk,7509.2714,0.0073
147,98,245,Cf,7499.6644,0.0099
152,94,246,Pu,7506.5401,0.0609
150,96,246,Cm,7511.4716,0.0062
149,97,246,Bk,7502.8035,0.244
148,98,246,Cf,7499.122,0.0062
147,99,246,Es,7480.7849,0.3655
146,100,246,Fm,7467.9608,0.0556
151,96,247,Cm,7501.9318,0.0154
150,97,247,Bk,7498.9408,0.021
149,98,247,Cf,7493.2638,0.058
148,99,247,Es,7480.1005,0.0787
152,96,248,Cm,7496.7291,0.0095
151,97,248,Bk,7490.5975,0.2018
150,98,248,Cf,7491.044,0.0207
148,100,248,Fm,7465.9451,0.0343
153,96,249,Cm,7485.551,0.0095
152,97,249,Bk,7486.041,0.005
151,98,249,Cf,7483.3954,0.0048
149,100,249,Fm,7461.8649,0.0249
148,101,249,Md,7444.0169,0.6603
154,96,250,Cm,7478.9385,0.0411
153,97,250,Bk,7475.9594,0.0116
152,98,250,Cf,7479.9567,0.0062
150,100,250,Fm,7462.0905,0.0316
149,101,250,Md,7441.6533,0.3637
155,96,251,Cm,7466.7233,0.0904
154,97,251,Bk,7469.2637,0.0428
153,98,251,Cf,7470.5014,0.0155
152,99,251,Es,7465.8842,0.0211
151,100,251,Fm,7457.0013,0.0569
150,101,251,Md,7441.9005,0.0754
154,98,252,Cf,7465.3474,0.0094
153,99,252,Es,7457.2428,0.1986
152,100,252,Fm,7456.0351,0.0207
151,101,252,Md,7438.4444,0.3622
150,102,252,No,7425.7992,0.0369
155,98,253,Cf,7454.8297,0.0168
154,99,253,Es,7452.8879,0.0049
153,100,253,Fm,7448.4712,0.0061
151,102,253,No,7422.4719,0.0273
150,103,253,Lr,7402.918,0.6503
156,98,254,Cf,7449.2259,0.0451
155,99,254,Es,7443.5759,0.0116
154,100,254,Fm,7444.7936,0.0073
152,102,254,No,7423.5909,0.038
151,103,254,Lr,7401.1306,0.3595
156,99,255,Es,7437.8216,0.0424
155,100,255,Fm,7435.886,0.0154
154,101,255,Md,7428.7333,0.0218
153,102,255,No,7417.9403,0.0551
152,103,255,Lr,7402.5767,0.0694
156,100,256,Fm,7431.7888,0.0118
154,102,256,No,7416.5429,0.0295
153,103,256,Lr,7398.1605,0.3238
152,104,256,Rf,7385.4349,0.0697
157,100,257,Fm,7422.1942,0.0169
156,101,257,Md,7417.5845,0.0061
155,102,257,No,7409.6587,0.0241
153,104,257,Rf,7381.7053,0.0421
152,105,257,Db,7361.9767,0.6406
157,101,258,Md,7409.6615,0.0135
154,104,258,Rf,7382.5257,0.0624
153,105,258,Db,7359.4803,0.356
157,102,259,No,7399.9714,0.0246
154,105,259,Db,7360.3626,0.2189
154,106,260,Sg,7342.5632,0.079
157,104,261,Rf,7371.3858,0.2516
155,106,261,Sg,7339.771,0.0709
154,107,261,Bh,7317.3313,0.6889
156,106,262,Sg,7341.1736,0.0846
155,107,262,Bh,7315.7331,0.3552
156,108,264,Hs,7298.3762,0.1094
157,108,265,Hs,7296.2474,0.0904
158,108,266,Hs,7298.2611,0.1019
157,109,266,Mt,7270.7598,0.3627
159,110,269,Ds,7250.1551,0.1167
160,110,270,Ds,7253.7634,0.1455
